ACS Symposium Series = ACS Symp. Ser.
AIChE Journal = AIChE J.
ARKIVOC (Gainesville, FL, United States) = ARKIVOC (Gainesville, FL, U. S.)
ATLA, Alternatives to Laboratory Animals = ATLA, Altern. Lab. Anim.
Accounts of Chemical Research = Acc. Chem. Res.
Acta Biochimica Polonica = Acta Biochim. Pol.
Acta Chimica Slovenica = Acta Chim. Slov.
Acta Crystallographica, Section A: Foundations of Crystallography = Acta Crystallogr., Sect. A: Found. Crystallogr.
Acta Crystallographica, Section B: Structural Science = Acta Crystallogr., Sect. B: Struct. Sci.
Acta Crystallographica, Section C: Crystal Structure Communications = Acta Crystallogr., Sect. C: Cryst. Struct. Commun.
Acta Crystallographica, Section D: Biological Crystallography = Acta Crystallogr., Sect. D: Biol. Crystallogr.
Acta Crystallographica, Section E: Structure Reports Online = Acta Crystallogr., Sect. E: Struct. Rep. Online
Acta Crystallographica, Section F: Structural Biology and Crystallization Communications = Acta Crystallogr., Sect. F: Struct. Biol. Cryst. Commun.
Acta Hydrochimica et Hydrobiologica = Acta Hydrochim. Hydrobiol.
Acta Materialia = Acta Mater.
Acta Pharmaceutica (Zagreb, Croatia) = Acta Pharm. (Zagreb, Croatia)
Acta Pharmacologica Sinica = Acta Pharmacol. Sin.
Acta Physica Polonica, A = Acta Phys. Pol., A
Acta Physica Polonica, B = Acta Phys. Pol., B
Acta Physiologica Scandinavica = Acta Physiol. Scand.
Adsorption = Adsorption
Adsorption Science & Technology = Adsorpt. Sci. Technol.
Advanced Drug Delivery Reviews = Adv. Drug Delivery Rev.
Advanced Functional Materials = Adv. Funct. Mater.
Advanced Materials (Weinheim, Germany) = Adv. Mater. (Weinheim, Ger.)
Advanced Synthesis & Catalysis = Adv. Synth. Catal.
Advances in Applied Ceramics = Adv. Appl. Ceram.
Advances in Atomic, Molecular, and Optical Physics = Adv. At., Mol., Opt. Phys.
Advances in Chemical Physics = Adv. Chem. Phys.
Advances in Chromatography (New York, NY, United States) = Adv. Chromatogr. (N. Y., NY, U. S.)
Advances in Colloid and Interface Science = Adv. Colloid Interface Sci.
Advances in Electrochemical Science and Engineering = Adv. Electrochem. Sci. Eng.
Advances in Inorganic Chemistry = Adv. Inorg. Chem.
Advances in Polymer Science = Adv. Polym. Sci.
Advances in Polymer Technology = Adv. Polym. Technol.
Advances in Quantum Chemistry = Adv. Quantum Chem.
Advances in X-Ray Analysis = Adv. X-Ray Anal.
Aerosol Science and Technology = Aerosol Sci. Technol.
Afinidad = Afinidad
Aging Cell = Aging Cell
American Ceramic Society Bulletin = Am. Ceram. Soc. Bull.
American Journal of Clinical Nutrition = Am. J. Clin. Nutr.
American Journal of Human Genetics = Am. J. Hum. Genet.
American Journal of Physiology = Am. J. Physiol.
American Journal of Respiratory Cell and Molecular Biology = Am. J. Respir. Cell Mol. Biol.
American Mineralogist = Am. Mineral.
Amino Acids = Amino Acids
Anal. Chem. Indian Journal of Chemistry, Section A: Inorganic, Bio-inorganic, Physical, Theoretical & Analytical Chemistry = Indian J. Chem., Sect. A: Inorg., Bio-inorg., Phys., Theor.
Analyst (Cambridge, United Kingdom) = Analyst (Cambridge, U. K.)
Analytica Chimica Acta = Anal. Chim. Acta
Analytical Biochemistry = Anal. Biochem.
Analytical Chemistry = Anal. Chem.
Analytical Letters = Anal. Lett.
Analytical Sciences = Anal. Sci.
Analytical and Bioanalytical Chemistry = Anal. Bioanal. Chem.
Angewandte Chemie, International Edition = Angew. Chem., Int. Ed.
Animal Welfare = Anim. Welfare
Animal Welfare Information Center Bulletin = Anim. Welfare Inf. Cent. Bull.
Annales Pharmaceutiques Francaises = Ann. Pharm. Fr.
Annales de Chimie (Cachan, France) = Ann. Chim. (Cachan, Fr.)
Annali di Chimica (Rome, Italy) = Ann. Chim. (Rome, Italy)
Annals of Nuclear Energy = Ann. Nucl. Energy
Annals of Nutrition & Metabolism = Ann. Nutr. Metab.
Annals of Physics (San Diego, CA, United States) = Ann. Phys. (San Diego, CA, U. S.)
Annexins = Annexins
Annual Reports in Medicinal Chemistry = Annu. Rep. Med. Chem.
Annual Reports on NMR Spectroscopy = Annu. Rep. NMR Spectrosc.
Annual Reports on the Progress of Chemistry, Section A: Inorganic Chemistry = Annu. Rep. Prog. Chem., Sect. A: Inorg. Chem.
Annual Reports on the Progress of Chemistry, Section B: Organic Chemistry = Annu. Rep. Prog. Chem., Sect. B: Org. Chem.
Annual Reports on the Progress of Chemistry, Section C: Physical Chemistry = Annu. Rep. Prog. Chem., Sect. C: Phys. Chem.
Annual Review of Biochemistry = Annu. Rev. Biochem.
Annual Review of Biomedical Engineering = Annu. Rev. Biomed. Eng.
Annual Review of Biophysics and Biomolecular Structure = Annu. Rev. Biophys. Biomol. Struct.
Annual Review of Cell and Developmental Biology = Annu. Rev. Cell Dev. Biol.
Annual Review of Earth and Planetary Sciences = Annu. Rev. Earth Planet. Sci.
Annual Review of Entomology = Annu. Rev. Entomol.
Annual Review of Genetics = Annu. Rev. Genet.
Annual Review of Genomics and Human Genetics = Annu. Rev. Genomics Hum. Genet.
Annual Review of Immunology = Annu. Rev. Immunol.
Annual Review of Materials Research = Annu. Rev. Mater. Res.
Annual Review of Medicine = Annu. Rev. Med.
Annual Review of Microbiology = Annu. Rev. Microbiol.
Annual Review of Neuroscience = Annu. Rev. Neurosci.
Annual Review of Nuclear and Particle Science = Annu. Rev. Nucl. Part. Sci.
Annual Review of Nutrition = Annu. Rev. Nutr.
Annual Review of Pharmacology and Toxicology = Annu. Rev. Pharmacol. Toxicol.
Annual Review of Physical Chemistry = Annu. Rev. Phys. Chem.
Annual Review of Physiology = Annu. Rev. Physiol.
Annual Review of Phytopathology = Annu. Rev. Phytopathol.
Annual Review of Plant Biology = Annu. Rev. Plant Biol.
Anti-Cancer Drugs = Anti-Cancer Drugs
Antibiotiki i Khimioterapiya = Antibiot. Khimioter.
Antimicrobial Agents and Chemotherapy = Antimicrob. Agents Chemother.
Antioxidants & Redox Signaling = Antioxid. Redox Signaling
Antiviral Chemistry & Chemotherapy = Antiviral Chem. Chemother.
Antiviral Research = Antiviral Res.
Applied Biochemistry and Biotechnology = Appl. Biochem. Biotechnol.
Applied Biochemistry and Microbiology = Appl. Biochem. Microbiol.
Applied Catalysis, A: General = Appl. Catal., A
Applied Catalysis, B: Environmental = Appl. Catal., B
Applied Clay Science = Appl. Clay Sci.
Applied Geochemistry = Appl. Geochem.
Applied Microbiology and Biotechnology = Appl. Microbiol. Biotechnol.
Applied Organometallic Chemistry = Appl. Organomet. Chem.
Applied Physics A: Materials Science & Processing = Appl. Phys. A: Mater. Sci. Process.
Applied Physics B: Lasers and Optics = Appl. Phys. B: Lasers Opt.
Applied Physics Letters = Appl. Phys. Lett.
Applied Radiation and Isotopes = Appl. Radiat. Isot.
Applied Spectroscopy = Appl. Spectrosc.
Applied Surface Science = Appl. Surf. Sci.
Applied and Environmental Microbiology = Appl. Environ. Microbiol.
Aquacultural Engineering = Aquacult. Eng.
Aquaculture = Aquaculture
Aquaculture International = Aquacult. Int.
Aquaculture Nutrition = Aquacult. Nutr.
Aquaculture Research = Aquacult. Res.
Aquatic Toxicology = Aquat. Toxicol.
Archaea = Archaea
Archiv der Pharmazie (Weinheim, Germany) = Arch. Pharm. (Weinheim, Ger.)
Archives of Biochemistry and Biophysics = Arch. Biochem. Biophys.
Archives of Environmental Contamination and Toxicology = Arch. Environ. Contam. Toxicol.
Archives of Insect Biochemistry and Physiology = Arch. Insect Biochem. Physiol.
Archives of Microbiology = Arch. Microbiol.
Archives of Pharmacal Research = Arch. Pharmacal Res.
Archives of Physiology and Biochemistry = Arch. Physiol. Biochem.
Archives of Toxicology = Arch. Toxicol.
Archives of Virology = Arch. Virol.
Archivum Combustionis = Arch. Combust.
Arteriosclerosis, Thrombosis, and Vascular Biology = Arterioscler., Thromb., Vasc. Biol.
Arzneimittel Forschung = Arzneim. Forsch.
Asian Journal of Chemistry = Asian J. Chem.
Assay and Drug Development Technologies = Assay Drug Dev. Technol.
Atherosclerosis (Amsterdam, Netherlands) = Atherosclerosis (Amsterdam, Neth.)
Atmospheric Chemistry and Physics = Atmos. Chem. Phys.
Atmospheric Environment = Atmos. Environ.
Atomic Energy (New York, NY, United States) = At. Energy (N. Y., NY, U. S.)
Atomic Spectroscopy = At. Spectrosc.
Australian Journal of Chemistry = Aust. J. Chem.
Autonomic & Autacoid Pharmacology = Auton. Autacoid Pharmacol.
Azerbaidzhanskii Khimicheskii Zhurnal = Azerb. Khim. Zh.
Basic & Clinical Pharmacology & Toxicology = Basic Clin. Pharmacol. Toxicol.
Beilstein Journal of Organic Chemistry = Beilstein J. Org. Chem.
BioFactors = BioFactors
BioMetals = BioMetals
BioTechniques = BioTechniques
Biocatalysis and Biotransformation = Biocatal. Biotransform.
Biochemical Genetics = Biochem. Genet.
Biochemical Journal = Biochem. J.
Biochemical Pharmacology = Biochem. Pharmacol.
Biochemical Society Transactions = Biochem. Soc. Trans.
Biochemical Systematics and Ecology = Biochem. Syst. Ecol.
Biochemical and Biophysical Research Communications = Biochem. Biophys. Res. Commun.
Biochemistry = Biochemistry
Biochemistry (Moscow) = Biochemistry (Moscow)
Biochemistry and Cell Biology = Biochem. Cell Biol.
Biochemistry and Molecular Biology Education = Biochem. Mol. Biol. Educ.
Biochimica et Biophysica Acta = Biochim. Biophys. Acta
Biochimica et Biophysica Acta, Bioenergetics = Biochim. Biophys. Acta, Bioenerg.
Biochimica et Biophysica Acta, Biomembranes = Biochim. Biophys. Acta, Biomembr.
Biochimica et Biophysica Acta, Biophysics Including Photosynthesis = Biochim. Biophys. Acta, Biophys. Incl. Photosynth.
Biochimica et Biophysica Acta, Enzymology = Biochim. Biophys. Acta, Enzymol.
Biochimica et Biophysica Acta, Enzymology and Biological Oxidation = Biochim. Biophys. Acta, Enzymol. Biol. Oxid.
Biochimica et Biophysica Acta, Gene Structure and Expression = Biochim. Biophys. Acta, Gene Struct. Expression
Biochimica et Biophysica Acta, General Subjects = Biochim. Biophys. Acta, Gen. Subj.
Biochimica et Biophysica Acta, Lipids and Lipid Metabolism = Biochim. Biophys. Acta, Lipids Lipid Metab.
Biochimica et Biophysica Acta, Molecular Basis of Disease = Biochim. Biophys. Acta, Mol. Basis Dis.
Biochimica et Biophysica Acta, Molecular Cell Research = Biochim. Biophys. Acta, Mol. Cell Res.
Biochimica et Biophysica Acta, Molecular and Cell Biology of Lipids = Biochim. Biophys. Acta, Mol. Cell Biol. Lipids
Biochimica et Biophysica Acta, Mucoproteins and Mucopolysaccharides = Biochim. Biophys. Acta, Mucoproteins Mucopolysaccharides
Biochimica et Biophysica Acta, Protein Structure = Biochim. Biophys. Acta, Protein Struct.
Biochimica et Biophysica Acta, Protein Structure and Molecular Enzymology = Biochim. Biophys. Acta, Protein Struct. Mol. Enzymol.
Biochimica et Biophysica Acta, Proteins and Proteomics = Biochim. Biophys. Acta, Proteins Proteomics
Biochimica et Biophysica Acta, Reviews on Bioenergetics = Biochim. Biophys. Acta, Rev. Bioenerg.
Biochimica et Biophysica Acta, Reviews on Biomembranes = Biochim. Biophys. Acta, Rev. Biomembr.
Biochimica et Biophysica Acta, Reviews on Cancer = Biochim. Biophys. Acta, Rev. Cancer
Biochimica et Biophysica Acta, Specialized Section on Biophysical Subjects = Biochim. Biophys. Acta, Spec. Sect. Biophys. Subj.
Biochimica et Biophysica Acta, Specialized Section on Enzymological Subjects = Biochim. Biophys. Acta, Spec. Sect. Enzymol. Subj.
Biochimica et Biophysica Acta, Specialized Section on Lipids and Related Subjects = Biochim. Biophys. Acta, Spec. Sect. Lipids Relat. Subj.
Biochimie = Biochimie
Bioconjugate Chemistry = Bioconjugate Chem.
Bioelectrochemistry = Bioelectrochemistry
Biofizika = Biofizika
Biogenic Amines = Biog. Amines
Bioinformatics = Bioinformatics
Bioinorganic Chemistry and Applications = Bioinorg. Chem. Appl.
Biological & Pharmaceutical Bulletin = Biol. Pharm. Bull.
Biological Chemistry = Biol. Chem.
Biological Trace Element Research = Biol. Trace Elem. Res.
Biologicheskie Membrany = Biol. Membr.
Biology of Reproduction = Biol. Reprod.
Biomacromolecules = Biomacromolecules
Biomarkers = Biomarkers
Biomaterials = Biomaterials
Biomedical Chromatography = Biomed. Chromatogr.
Biomedical Research = Biomed. Res.
Biomeditsinskaya Khimiya = Biomed. Khim.
Biomolecular Engineering = Biomol. Eng.
Bioorganic & Medicinal Chemistry = Bioorg. Med. Chem.
Bioorganic & Medicinal Chemistry Letters = Bioorg. Med. Chem. Lett.
Bioorganic Chemistry = Bioorg. Chem.
Biopharmaceutics & Drug Disposition = Biopharm. Drug Dispos.
Biophysical Chemistry = Biophys. Chem.
Biophysical Journal = Biophys. J.
Biopolymers = Biopolymers
Bioprocess and Biosystems Engineering = Bioprocess Biosyst. Eng.
Bioresource Technology = Bioresour. Technol.
Bioscience Reports = Biosci. Rep.
Bioscience, Biotechnology, and Biochemistry = Biosci., Biotechnol., Biochem.
Biosensors & Bioelectronics = Biosens. Bioelectron.
Biotechnology Letters = Biotechnol. Lett.
Biotechnology Progress = Biotechnol. Prog.
Biotechnology and Applied Biochemistry = Biotechnol. Appl. Biochem.
Biotechnology and Bioengineering = Biotechnol. Bioeng.
Biotechnology and Bioprocess Engineering = Biotechnol. Bioprocess Eng.
Birth Defects Research, Part A: Clinical and Molecular Teratology = Birth Defects Res., Part A
Birth Defects Research, Part B: Developmental and Reproductive Toxicology = Birth Defects Res., Part B
Birth Defects Research, Part C: Embryo Today--Reviews = Birth Defects Res., Part C
Bitamin = Bitamin
Blood = Blood
Bopuxue Zazhi = Bopuxue Zazhi
Brain Research = Brain Res.
British Journal of Nutrition = Br. J. Nutr.
British Journal of Pharmacology = Br. J. Pharmacol.
Bulgarian Chemical Communications = Bulg. Chem. Commun.
Bulletin of Electrochemistry = Bull. Electrochem.
Bulletin of Environmental Contamination and Toxicology = Bull. Environ. Contam. Toxicol.
Bulletin of Materials Science = Bull. Mater. Sci.
Bulletin of the Chemical Society of Japan = Bull. Chem. Soc. Jpn.
Bulletin of the Korean Chemical Society = Bull. Korean Chem. Soc.
Bunseki Kagaku = Bunseki Kagaku
CALPHAD: Computer Coupling of Phase Diagrams and Thermochemistry = CALPHAD: Comput. Coupling Phase Diagrams Thermochem.
Cailiao Rechuli Xuebao = Cailiao Rechuli Xuebao
Calcified Tissue International = Calcif. Tissue Int.
Canadian Journal of Analytical Sciences and Spectroscopy = Can. J. Anal. Sci. Spectrosc.
Canadian Journal of Chemical Engineering = Can. J. Chem. Eng.
Canadian Journal of Chemistry = Can. J. Chem.
Canadian Journal of Fisheries and Aquatic Sciences = Can. J. Fish. Aquat. Sci.
Canadian Journal of Microbiology = Can. J. Microbiol.
Canadian Journal of Physics = Can. J. Phys.
Canadian Journal of Physiology and Pharmacology = Can. J. Physiol. Pharmacol.
Canadian Journal of Zoology = Can. J. Zool.
Canadian Metallurgical Quarterly = Can. Metall. Q.
Canadian Mineralogist = Can. Mineral.
Cancer Cell = Cancer Cell
Cancer Gene Therapy = Cancer Gene Ther.
Cancer Genomics & Proteomics = Cancer Genomics Proteomics
Cancer Letters (Amsterdam, Netherlands) = Cancer Lett. (Amsterdam, Neth.)
Cancer Research = Cancer Res.
Cancer Science = Cancer Sci.
Carbohydrate Polymers = Carbohydr. Polym.
Carbohydrate Research = Carbohydr. Res.
Carbon = Carbon
Carcinogenesis = Carcinogenesis
Cardiovascular Research = Cardiovasc. Res.
Catalysis Communications = Catal. Commun.
Catalysis Letters = Catal. Lett.
Catalysis Reviews - Science and Engineering = Catal. Rev. - Sci. Eng.
Catalysis Today = Catal. Today
Cell (Cambridge, MA, United States) = Cell (Cambridge, MA, U. S.)
Cell Biochemistry and Biophysics = Cell Biochem. Biophys.
Cell Biochemistry and Function = Cell Biochem. Funct.
Cell Calcium = Cell Calcium
Cell Cycle = Cell Cycle
Cell Metabolism = Cell Metab.
Cellular Immunology = Cell. Immunol.
Cellular Microbiology = Cell. Microbiol.
Cellular Physiology and Biochemistry = Cell. Physiol. Biochem.
Cellular Polymers = Cell. Polym.
Cellular and Molecular Biology (Paris, France, Online) = Cell. Mol. Biol. (Paris, Fr., Online)
Cellular and Molecular Biology (Sarreguemines, France, Print) = Cell. Mol. Biol. (Sarreguemines, Fr., Print)
Cellular and Molecular Life Sciences = Cell. Mol. Life Sci.
Cellulose Chemistry and Technology = Cellul. Chem. Technol.
Cement & Concrete Composites = Cem. Concr. Compos.
Cement and Concrete Research = Cem. Concr. Res.
Ceramics International = Ceram. Int.
Ceramics-Silikaty = Ceram.-Silik.
Cereal Chemistry = Cereal Chem.
Ceska a Slovenska Farmacie = Ceska Slov. Farm.
ChemBioChem = ChemBioChem
ChemPhysChem = ChemPhysChem
Chemia Analityczna (Warsaw, Poland) = Chem. Anal. (Warsaw, Pol.)
Chemical & Pharmaceutical Bulletin = Chem. Pharm. Bull.
Chemical Communications (Cambridge, United Kingdom) = Chem. Commun. (Cambridge, U. K.)
Chemical Engineering & Technology = Chem. Eng. Technol.
Chemical Engineering Communications = Chem. Eng. Commun.
Chemical Engineering Journal (Amsterdam, Netherlands) = Chem. Eng. J. (Amsterdam, Neth.)
Chemical Engineering Progress = Chem. Eng. Prog.
Chemical Engineering Research and Design = Chem. Eng. Res. Des.
Chemical Engineering Science = Chem. Eng. Sci.
Chemical Engineering and Processing = Chem. Eng. Process.
Chemical Geology = Chem. Geol.
Chemical Papers = Chem. Pap.
Chemical Physics = Chem. Phys.
Chemical Physics Letters = Chem. Phys. Lett.
Chemical Record = Chem. Rec.
Chemical Research in Chinese Universities = Chem. Res. Chin. Univ.
Chemical Research in Toxicology = Chem. Res. Toxicol.
Chemical Reviews (Washington, DC, United States) = Chem. Rev. (Washington, DC, U. S.)
Chemical Society Reviews = Chem. Soc. Rev.
Chemical Speciation and Bioavailability = Chem. Speciation Bioavailability
Chemical Vapor Deposition = Chem. Vap. Deposition
Chemical and Biochemical Engineering Quarterly = Chem. Biochem. Eng. Q.
Chemicke Listy = Chem. Listy
Chemico-Biological Interactions = Chem.-Biol. Interact.
Chemie Ingenieur Technik = Chem. Ing. Tech.
Chemie der Erde = Chem. Erde
Chemija = Chemija
Chemistry & Biodiversity = Chem. Biodiversity
Chemistry & Biology (Cambridge, MA, United States) = Chem. Biol. (Cambridge, MA, U. S.)
Chemistry & Industry (London, United Kingdom) = Chem. Ind. (London, U. K.)
Chemistry Letters = Chem. Lett.
Chemistry and Physics of Lipids = Chem. Phys. Lipids
Chemistry and Technology of Fuels and Oils = Chem. Technol. Fuels Oils
Chemistry of Heterocyclic Compounds (New York, NY, United States) = Chem. Heterocycl. Compd. (N. Y., NY, U. S.)
Chemistry of Materials = Chem. Mater.
Chemistry of Natural Compounds = Chem. Nat. Compd.
Chemistry--A European Journal = Chem.--Eur. J.
Chemometrics and Intelligent Laboratory Systems = Chemom. Intell. Lab. Syst.
Chemosphere = Chemosphere
Chemotherapy (Basel, Switzerland) = Chemotherapy (Basel, Switz.)
Chemtracts = Chemtracts
Chimia = Chimia
Chimica e l'Industria (Milan, Italy) = Chim. Ind. (Milan, Italy)
Chinese Chemical Letters = Chin. Chem. Lett.
Chinese Journal of Chemical Engineering = Chin. J. Chem. Eng.
Chinese Journal of Chemistry = Chin. J. Chem.
Chinese Journal of Geochemistry = Chin. J. Geochem.
Chinese Journal of Polymer Science = Chin. J. Polym. Sci.
Chirality = Chirality
Chromatographia = Chromatographia
Chromosome Research = Chromosome Res.
Circulation Research = Circ. Res.
Clay Minerals = Clay Miner.
Clays and Clay Minerals = Clays Clay Miner.
Clinica Chimica Acta = Clin. Chim. Acta
Clinical Chemistry (Washington, DC, United States) = Clin. Chem. (Washington, DC, U. S.)
Clinical Chemistry and Laboratory Medicine = Clin. Chem. Lab. Med.
Clinical Immunology (San Diego, CA, United States) = Clin. Immunol. (San Diego, CA, U. S.)
Clinical Proteomics = Clin. Proteomics
Clinical and Diagnostic Laboratory Immunology = Clin. Diagn. Lab. Immunol.
Clinical and Experimental Pharmacology and Physiology = Clin. Exp. Pharmacol. Physiol.
Cloning and Stem Cells = Cloning Stem Cells
Coal Preparation (Philadelphia, PA, United States) = Coal Prep. (Philadelphia, PA, U. S.)
Collection of Czechoslovak Chemical Communications = Collect. Czech. Chem. Commun.
Colloid Journal = Colloid J.
Colloid and Polymer Science = Colloid Polym. Sci.
Colloids and Surfaces, A: Physicochemical and Engineering Aspects = Colloids Surf., A
Colloids and Surfaces, B: Biointerfaces = Colloids Surf., B
Coloration Technology = Color. Technol.
Combinatorial Chemistry and High Throughput Screening = Comb. Chem. High Throughput Screening
Combustion Science and Technology = Combust. Sci. Technol.
Combustion and Flame = Combust. Flame
Comments on Inorganic Chemistry = Comments Inorg. Chem.
Communications in Soil Science and Plant Analysis = Commun. Soil Sci. Plant Anal.
Comparative Biochemistry and Physiology, Part A: Molecular & Integrative Physiology = Comp. Biochem. Physiol., Part A: Mol. Integr. Physiol.
Comparative Biochemistry and Physiology, Part B: Biochemistry & Molecular Biology = Comp. Biochem. Physiol., Part B: Biochem. Mol. Biol.
Comparative Biochemistry and Physiology, Part C: Toxicology & Pharmacology = Comp. Biochem. Physiol., Part C: Toxicol. Pharmacol.
Comparative Medicine = Comp. Med.
Comparative and Functional Genomics = Comp. Funct. Genomics
Comptes Rendus Chimie = C. R. Chim.
Comptes Rendus Physique = C. R. Phys.
Computational Biology and Chemistry = Comput. Biol. Chem.
Computer Physics Communications = Comput. Phys. Commun.
Computers & Chemical Engineering = Comput. Chem. Eng.
Comunicaciones presentadas a las Jornadas del Comite Espanol de la Detergencia = Comun. Jorn. Com. Esp. Deterg.
Contemporary Topics in Laboratory Animal Science = Contemp. Top. Lab. Anim. Sci.
Contributions to Mineralogy and Petrology = Contrib. Mineral. Petrol.
Coordination Chemistry Reviews = Coord. Chem. Rev.
Corrosion (Houston, TX, United States) = Corrosion (Houston, TX, U. S.)
Corrosion Engineering, Science and Technology = Corros. Eng., Sci. Technol.
Corrosion Reviews = Corros. Rev.
Corrosion Science = Corros. Sci.
Critical Reviews in Analytical Chemistry = Crit. Rev. Anal. Chem.
Critical Reviews in Solid State and Materials Sciences = Crit. Rev. Solid State Mater. Sci.
Croatica Chemica Acta = Croat. Chem. Acta
Cryogenics = Cryogenics
CrystEngComm = CrystEngComm
Crystal Growth & Design = Cryst. Growth Des.
Crystal Research and Technology = Cryst. Res. Technol.
Crystallography Reports = Crystallogr. Rep.
Cuihua Xuebao = Cuihua Xuebao
Current Alzheimer Research = Curr. Alzheimer Res.
Current Analytical Chemistry = Curr. Anal. Chem.
Current Biology = Curr. Biol.
Current Cancer Drug Targets = Curr. Cancer Drug Targets
Current Computer-Aided Drug Design = Curr. Comput.-Aided Drug Des.
Current Drug Delivery = Curr. Drug Delivery
Current Drug Discovery Technologies = Curr. Drug Discovery Technol.
Current Drug Metabolism = Curr. Drug Metab.
Current Drug Targets = Curr. Drug Targets
Current Drug Targets: CNS & Neurological Disorders = Curr. Drug Targets: CNS Neurol. Disord.
Current Drug Targets: Cardiovascular & Haematological Disorders = Curr. Drug Targets: Cardiovasc. & Haematol. Disord.
Current Drug Targets: Immune, Endocrine and Metabolic Disorders = Curr. Drug Targets: Immune, Endocr. Metab. Disord.
Current Drug Targets: Infectious Disorders = Curr. Drug Targets: Infect. Disord.
Current Drug Targets: Inflammation & Allergy = Curr. Drug Targets: Inflammation Allergy
Current Enzyme Inhibition = Curr. Enzyme Inhib.
Current Gene Therapy = Curr. Gene Ther.
Current Genetics = Curr. Genet.
Current Genomics = Curr. Genomics
Current HIV Research = Curr. HIV Res.
Current Immunology Reviews = Curr. Immunol. Rev.
Current Medicinal Chemistry = Curr. Med. Chem.
Current Medicinal Chemistry: Anti-Cancer Agents = Curr. Med. Chem.: Anti-Cancer Agents
Current Medicinal Chemistry: Anti-Infective Agents = Curr. Med. Chem.: Anti-Infect. Agents
Current Medicinal Chemistry: Anti-Inflammatory & Anti-Allergy Agents = Curr. Med. Chem.: Anti-Inflammatory Anti-Allergy Agents
Current Medicinal Chemistry: Cardiovascular & Hematological Agents = Curr. Med. Chem.: Cardiovasc. Hematol. Agents
Current Medicinal Chemistry: Central Nervous System Agents = Curr. Med. Chem.: Cent. Nerv. Syst. Agents
Current Medicinal Chemistry: Immunology, Endocrine & Metabolic Agents = Curr. Med. Chem.: Immunol., Endocr. Metab. Agents
Current Microbiology = Curr. Microbiol.
Current Molecular Medicine = Curr. Mol. Med.
Current Neuropharmacology = Curr. Neuropharmacol.
Current Opinion in Biotechnology = Curr. Opin. Biotechnol.
Current Opinion in Cell Biology = Curr. Opin. Cell Biol.
Current Opinion in Chemical Biology = Curr. Opin. Chem. Biol.
Current Opinion in Colloid & Interface Science = Curr. Opin. Colloid Interface Sci.
Current Opinion in Drug Discovery & Development = Curr. Opin. Drug Discovery Dev.
Current Opinion in Genetics & Development = Curr. Opin. Genet. Dev.
Current Opinion in Immunology = Curr. Opin. Immunol.
Current Opinion in Lipidology = Curr. Opin. Lipidol.
Current Opinion in Neurobiology = Curr. Opin. Neurobiol.
Current Opinion in Pharmacology = Curr. Opin. Pharmacol.
Current Opinion in Structural Biology = Curr. Opin. Struct. Biol.
Current Organic Chemistry = Curr. Org. Chem.
Current Organic Synthesis = Curr. Org. Synth.
Current Pharmaceutical Analysis = Curr. Pharm. Anal.
Current Pharmaceutical Biotechnology = Curr. Pharm. Biotechnol.
Current Pharmaceutical Design = Curr. Pharm. Des.
Current Pharmacogenomics = Curr. Pharmacogenomics
Current Protein and Peptide Science = Curr. Protein Pept. Sci.
Current Proteomics = Curr. Proteomics
Current Separations = Curr. Sep.
Current Topics in Medicinal Chemistry (Sharjah, United Arab Emirates) = Curr. Top. Med. Chem. (Sharjah, United Arab Emirates)
Current Vascular Pharmacology = Curr. Vasc. Pharmacol.
Cytokine & Growth Factor Reviews = Cytokine Growth Factor Rev.
Cytokine+ = Cytokine+
DNA Repair = DNA Repair
DNA Research = DNA Res.
DNA Sequence = DNA Sequence
DNA and Cell Biology = DNA Cell Biol.
Dalton Transactions = Dalton Trans.
Desalination = Desalination
Designed Monomers and Polymers = Des. Monomers Polym.
Development (Cambridge, United Kingdom) = Development (Cambridge, U. K.)
Developmental Biology (San Diego, CA, United States) = Dev. Biol. (San Diego, CA, U. S.)
Developmental Brain Research = Dev. Brain Res.
Developmental Cell = Dev. Cell
Developmental Neuroscience (Basel, Switzerland) = Dev. Neurosci. (Basel, Switz.)
Developments in Biologicals (Basel, Switzerland) = Dev. Biol. (Basel, Switz.)
Diabetes = Diabetes
Diamond and Related Materials = Diamond Relat. Mater.
Dianhuaxue = Dianhuaxue
Differentiation (Malden, MA, United States) = Differentiation (Malden, MA, U. S.)
Diffusion and Defect Data--Solid State Data, Pt. A: Defect and Diffusion Forum = Diffus. Defect Data, Pt. A
Diffusion and Defect Data--Solid State Data, Pt. B: Solid State Phenomena = Diffus. Defect Data, Pt. B
Diqiu Huaxue = Diqiu Huaxue
Doklady Biochemistry and Biophysics = Dokl. Biochem. Biophys.
Doklady Chemistry = Dokl. Chem.
Doklady Earth Sciences = Dokl. Earth Sci.
Doklady Physical Chemistry = Dokl. Phys. Chem.
Doklady Physics = Dokl. Phys.
Dopovidi Natsional'noi Akademii Nauk Ukraini = Dopov. Nats. Akad. Nauk Ukr.
Drug Delivery = Drug Delivery
Drug Development Research = Drug Dev. Res.
Drug Development and Industrial Pharmacy = Drug Dev. Ind. Pharm.
Drug Metabolism and Disposition = Drug Metab. Dispos.
Drug Metabolism and Drug Interactions = Drug Metab. Drug Interact.
Drug Metabolism and Pharmacokinetics = Drug Metab. Pharmacokinet.
Drug and Chemical Toxicology (1977) = Drug Chem. Toxicol. (1977)
Dyes and Pigments = Dyes Pigm.
EMBO Journal = EMBO J.
EMBO Reports = EMBO Rep.
Earth and Planetary Science Letters = Earth Planet. Sci. Lett.
Ecological Modelling = Ecol. Model.
Economic Geology = Econ. Geol.
Ecotoxicology and Environmental Safety = Ecotoxicol. Environ. Saf.
Ekotekhnologii i Resursosberezhenie = Ekotekhnol. Resursosberezhenie
Eksperimental'naya i Klinicheskaya Farmakologiya = Eksp. Klin. Farmakol.
Electroanalysis = Electroanalysis
Electrochemical Society Interface = Electrochem. Soc. Interface
Electrochemical and Solid-State Letters = Electrochem. Solid-State Lett.
Electrochemistry (Tokyo, Japan) = Electrochemistry (Tokyo, Jpn.)
Electrochemistry Communications = Electrochem. Commun.
Electrochimica Acta = Electrochim. Acta
Electrophoresis = Electrophoresis
Endocrine = Endocrine
Endocrinology = Endocrinology
Energy & Fuels = Energy Fuels
Engineering in Life Sciences = Eng. Life Sci.
Environ. Chem. Preprints of Extended Abstracts presented at the ACS National Meeting, American Chemical Society, Division of Environmental Chemistry = Prepr. Ext. Abstr. ACS Natl. Meet., Am. Chem. Soc., Div.
Environ. Eng. Journal of Environmental Science and Health, Part A: Toxic/Hazardous Substances & Environmental Engineering = J. Environ. Sci. Health, Part A: Toxic/Hazard. Subst.
Environment Protection Engineering = Environ. Prot. Eng.
Environmental Chemistry = Environ. Chem.
Environmental Chemistry Letters = Environ. Chem. Lett.
Environmental Engineering Science = Environ. Eng. Sci.
Environmental Geochemistry and Health = Environ. Geochem. Health
Environmental Pollution (Amsterdam, Netherlands) = Environ. Pollut. (Amsterdam, Neth.)
Environmental Progress = Environ. Prog.
Environmental Research = Environ. Res.
Environmental Science and Technology = Environ. Sci. Technol.
Environmental Technology = Environ. Technol.
Environmental Toxicology = Environ. Toxicol.
Environmental Toxicology and Chemistry = Environ. Toxicol. Chem.
Environmental Toxicology and Pharmacology = Environ. Toxicol. Pharmacol.
Environmental and Molecular Mutagenesis = Environ. Mol. Mutagen.
Enzyme and Microbial Technology = Enzyme Microb. Technol.
Erdoel, Erdgas, Kohle = Erdoel, Erdgas, Kohle
Eukaryotic Cell = Eukaryotic Cell
European Cytokine Network = Eur. Cytokine Network
European Food Research and Technology = Eur. Food Res. Technol.
European Journal of Cell Biology = Eur. J. Cell Biol.
European Journal of Drug Metabolism and Pharmacokinetics = Eur. J. Drug Metab. Pharmacokinet.
European Journal of Endocrinology = Eur. J. Endocrinol.
European Journal of Immunology = Eur. J. Immunol.
European Journal of Inorganic Chemistry = Eur. J. Inorg. Chem.
European Journal of Lipid Science and Technology = Eur. J. Lipid Sci. Technol.
European Journal of Mass Spectrometry = Eur. J. Mass Spectrom.
European Journal of Medicinal Chemistry = Eur. J. Med. Chem.
European Journal of Mineralogy = Eur. J. Mineral.
European Journal of Organic Chemistry = Eur. J. Org. Chem.
European Journal of Pharmaceutical Sciences = Eur. J. Pharm. Sci.
European Journal of Pharmacology = Eur. J. Pharmacol.
European Neuropsychopharmacology = Eur. Neuropsychopharmacol.
European Physical Journal A: Hadrons and Nuclei = Eur. Phys. J. A
European Physical Journal B: Condensed Matter Physics = Eur. Phys. J. B
European Physical Journal C: Particles and Fields = Eur. Phys. J. C
European Physical Journal D: Atomic, Molecular and Optical Physics = Eur. Phys. J. D
European Physical Journal E: Soft Matter = Eur. Phys. J. E
European Polymer Journal = Eur. Polym. J.
Europhysics Letters = Europhys. Lett.
Experimental Animals = Exp. Anim.
Experimental Biology and Medicine (Maywood, NJ, United States) = Exp. Biol. Med. (Maywood, NJ, U. S.)
Experimental Cell Research = Exp. Cell Res.
Experimental Eye Research = Exp. Eye Res.
Experimental and Clinical Endocrinology & Diabetes = Exp. Clin. Endocrinol. Diabetes
Experimental and Molecular Medicine = Exp. Mol. Med.
Experimental and Molecular Pathology = Exp. Mol. Pathol.
Expert Opinion on Investigational Drugs = Expert Opin. Invest. Drugs
Expert Opinion on Therapeutic Patents = Expert Opin. Ther. Pat.
FASEB Journal = FASEB J.
FEBS Journal = FEBS J.
FEBS Letters = FEBS Lett.
FEMS Immunology and Medical Microbiology = FEMS Immunol. Med. Microbiol.
FEMS Microbiology Ecology = FEMS Microbiol. Ecol.
FEMS Microbiology Letters = FEMS Microbiol. Lett.
FEMS Microbiology Reviews = FEMS Microbiol. Rev.
FEMS Yeast Research = FEMS Yeast Res.
Faraday Discussions = Faraday Discuss.
Farmaco = Farmaco
Fenxi Huaxue = Fenxi Huaxue
Fenzi Cuihua = Fenzi Cuihua
Ferroelectrics = Ferroelectrics
Ferroelectrics, Letters Section = Ferroelectr., Lett. Sect.
Fibre Chemistry = Fibre Chem.
Fire and Materials = Fire Mater.
Fish Physiology and Biochemistry = Fish Physiol. Biochem.
Fisheries Oceanography = Fish. Oceanogr.
Fisheries Science = Fish. Sci.
Fisheries Science (Carlton, Australia) = Fish. Sci. (Carlton, Aust.)
Fizika Goreniya i Vzryva = Fiz. Goreniya Vzryva
Fizika Metallov i Metallovedenie = Fiz. Met. Metalloved.
Fizika i Khimiya Obrabotki Materialov = Fiz. Khim. Obrab. Mater.
Fluid Phase Equilibria = Fluid Phase Equilib.
Folia Microbiologica (Prague, Czech Republic) = Folia Microbiol. (Prague, Czech Repub.)
Food Additives & Contaminants = Food Addit. Contam.
Food Chemistry = Food Chem.
Food Hydrocolloids = Food Hydrocolloids
Food and Chemical Toxicology = Food Chem. Toxicol.
Free Radical Biology & Medicine = Free Radical Biol. Med.
Free Radical Research = Free Radical Res.
Fresenius Environmental Bulletin = Fresenius Environ. Bull.
Fuel = Fuel
Fuel Cells (Weinheim, Germany) = Fuel Cells (Weinheim, Ger.)
Fuel Processing Technology = Fuel Process. Technol.
Fullerenes, Nanotubes, and Carbon Nanostructures = Fullerenes, Nanotubes, Carbon Nanostruct.
Functional & Integrative Genomics = Funct. Integr. Genomics
Fundamental & Clinical Pharmacology = Fundam. Clin. Pharmacol.
Funtai oyobi Funmatsu Yakin = Funtai oyobi Funmatsu Yakin
Fusion Engineering and Design = Fusion Eng. Des.
Fusion Science and Technology = Fusion Sci. Technol.
Ganguang Kexue Yu Guang Huaxue = Ganguang Kexue Yu Guang Huaxue
Gaodeng Xuexiao Huaxue Xuebao = Gaodeng Xuexiao Huaxue Xuebao
Gaofenzi Cailiao Kexue Yu Gongcheng = Gaofenzi Cailiao Kexue Yu Gongcheng
Gaofenzi Xuebao = Gaofenzi Xuebao
Gaoneng Wuli Yu Hewuli = Gaoneng Wuli Yu Hewuli
Gaoxiao Huaxue Gongcheng Xuebao = Gaoxiao Huaxue Gongcheng Xuebao
Gene = Gene
Gene Expression Patterns = Gene Expression Patterns
Gene Therapy = Gene Ther.
Gene Therapy and Regulation = Gene Ther. Regul.
General and Comparative Endocrinology = Gen. Comp. Endocrinol.
Genes & Development = Genes Dev.
Genes to Cells = Genes Cells
Genes, Chromosomes & Cancer = Genes, Chromosomes Cancer
Genome Research = Genome Res.
Genomics = Genomics
Geochemical Journal = Geochem. J.
Geochimica et Cosmochimica Acta = Geochim. Cosmochim. Acta
Geokhimiya = Geokhimiya
Glass Physics and Chemistry = Glass Phys. Chem.
Glass Science and Technology (Offenbach, Germany) = Glass Sci. Technol. (Offenbach, Ger.)
Glass Technology = Glass Technol.
GlassResearcher = GlassResearcher
Global Biogeochemical Cycles = Global Biogeochem. Cycles
Glycobiology = Glycobiology
Glycoconjugate Journal = Glycoconjugate J.
Gongneng Gaofenzi Xuebao = Gongneng Gaofenzi Xuebao
Ground Water = Ground Water
Growth Factors = Growth Factors
Guangpuxue Yu Guangpu Fenxi = Guangpuxue Yu Guangpu Fenxi
Guijinshu = Guijinshu
Guisuanyan Xuebao = Guisuanyan Xuebao
Guocheng Gongcheng Xuebao = Guocheng Gongcheng Xuebao
Health Physics = Health Phys.
Heat Transfer Engineering = Heat Transfer Eng.
Hecheng Xiangjiao Gongye = Hecheng Xiangjiao Gongye
Helvetica Chimica Acta = Helv. Chim. Acta
Hemoglobin = Hemoglobin
Heteroatom Chemistry = Heteroat. Chem.
Heterocycles = Heterocycles
Heterocyclic Communications = Heterocycl. Commun.
High Energy Chemistry = High Energy Chem.
High Performance Polymers = High Perform. Polym.
High Temperature = High Temp.
High Temperature Materials and Processes (London, United Kingdom) = High Temp. Mater. Processes (London, U. K.)
High Temperatures - High Pressures = High Temp. - High Pressures
Histochemistry and Cell Biology = Histochem. Cell Biol.
Holzforschung = Holzforschung
Hormone Research = Horm. Res.
Hormone and Metabolic Research = Horm. Metab. Res.
Huadong Ligong Daxue Xuebao, Ziran Kexueban = Huadong Ligong Daxue Xuebao, Ziran Kexueban
Huagong Xuebao (Chinese Edition) = Huagong Xuebao (Chin. Ed.)
Huanjing Huaxue = Huanjing Huaxue
Huanjing Kexue Xuebao = Huanjing Kexue Xuebao
Huaxue = Huaxue
Huaxue Fanying Gongcheng Yu Gongyi = Huaxue Fanying Gongcheng Yu Gongyi
Huaxue Shiji = Huaxue Shiji
Huaxue Tongbao = Huaxue Tongbao
Huaxue Wuli Xuebao = Huaxue Wuli Xuebao
Huaxue Xuebao = Huaxue Xuebao
Human Gene Therapy = Hum. Gene Ther.
Human Molecular Genetics = Hum. Mol. Genet.
Hungarian Journal of Industrial Chemistry = Hung. J. Ind. Chem.
Hwahak Konghak = Hwahak Konghak
Hydrometallurgy = Hydrometallurgy
Hyperfine Interactions = Hyperfine Interact.
Hypertension = Hypertension
IEEE Aerospace and Electronic Systems Magazine = IEEE Aero. El. Sys. Mag.
IEEE Annals of the History of Computing = IEEE Ann. Hist. Comput.
IEEE Antennas and Propagation Magazine = IEEE Antennas. Propag.
IEEE Antennas and Wireless Propagation Letters = IEEE Antenn. Wirel. Pr.
IEEE Circuits & Devices = IEEE Circuits. Device.
IEEE Circuits and Devices Magazine = IEEE Circuit. Devic.
IEEE Communications Letters = IEEE Commun. Lett.
IEEE Communications Magazine = IEEE Commun. Mag.
IEEE Computational Science & Engineering = IEEE Comput. Sci. Eng.
IEEE Computer Applications in Power = IEEE Comput. Appl. Pow.
IEEE Computer Graphics and Applications = IEEE Comput. Graph.
IEEE Computer Group News = IEEE Comput. Group. N.
IEEE Concurrency = IEEE Concurr.
IEEE Control Systems Magazine = IEEE Contr. Syst. Mag.
IEEE Design & Test of Computers = IEEE Des. Test. Comput.
IEEE Electrical Insulation Magazine = IEEE Electr. Insul. M.
IEEE Electromagnetic Compatibility Symposium Record = IEEE Electroman. Comp.
IEEE Electron Device Letters = IEEE Electr. Device. L.
IEEE Engineering in Medicine and Biology Magazine = IEEE Eng. Med. Biol.
IEEE Expert-intelligent Systems & their Applications = IEEE Expert.
IEEE Geoscience and Remote Sensing Letters = IEEE Geosci. Remote. S.
IEEE Industry Applications Magazine = IEEE Ind. Appl. Mag.
IEEE Instrumentation & Measurement Magazine = IEEE Instru. Meas. Mag.
IEEE Intelligent Systems = IEEE Intell. Syst.
IEEE Intelligent Systems & their Applications = IEEE Intell. Syst. App.
IEEE Internet Computing = IEEE Internet. Comput.
IEEE Journal of Oceanic Engineering = IEEE J. Oceanic. Eng.
IEEE Journal of Quantum Electronics = IEEE J. Quantum. Electron.
IEEE Journal of Robotics and Automation = IEEE T. Robotic. Autom.
IEEE Journal of Selected Topics in Quantum Electronics = IEEE J. Sel. Topics in Quantum Electron.
IEEE Journal of Solid-State Circuits = IEEE J. Solid-St. Circ.
IEEE Journal on Selected Areas in Communications = IEEE J. Sel. Area. Comm.
IEEE Micro = IEEE Micro.
IEEE Microwave Magazine = IEEE Microw. Mag.
IEEE Microwave and Guided Wave Letters = IEEE Microw. Guided. W.
IEEE Microwave and Wireless Components Letters = IEEE Microw. Wirel. Co.
IEEE Multimedia = IEEE Multimedia.
IEEE Network = IEEE Network.
IEEE Parallel & Distributed Technology = IEEE Parall. Distrib.
IEEE Personal Communications = IEEE Pers. Commun.
IEEE Pervasive Computing = IEEE Pervas. Comput.
IEEE Photonics Technology Letters = IEEE Photonic. Tech. L.
IEEE Potentials = IEEE Potentials.
IEEE Robotics & Automation Magazine = IEEE Robot. Autom. Mag.
IEEE Security & Privacy = IEEE Secur. Priv.
IEEE Sensors Journal = IEEE Sens. J.
IEEE Signal Processing Letters = IEEE Signal. Proc. Let.
IEEE Signal Processing Magazine = IEEE Signal. Proc. Mag.
IEEE Software = IEEE Software.
IEEE Spectrum = IEEE Spectrum.
IEEE Technology and Society Magazine = IEEE Technol. Soc. Mag.
IEEE Transactions on Acoustics Speech and Signal Processing = IEEE T. Acoust. Speech.
IEEE Transactions on Advanced Packaging = IEEE Trans. Adv. Pack.
IEEE Transactions on Aerospace = IEEE T. Aerosp.
IEEE Transactions on Aerospace and Electronic Systems = IEEE T. Aero. Elec. Sys.
IEEE Transactions on Aerospace and Naval Electronics = IEEE T. Aero. Nav. Elec.
IEEE Transactions on Aerospace and Navigational Electronics = IEEE Trans. Aerosp. N.
IEEE Transactions on Antennas and Propagation = IEEE T. Antenn. Propag.
IEEE Transactions on Applications and Industry = IEEE T. Appl. Ind.
IEEE Transactions on Applied Superconductivity = IEEE T. Appl. Supercon.
IEEE Transactions on Audio = IEEE Trans. Audio.
IEEE Transactions on Audio Speech and Language Processing = IEEE T. Audio. Speech.
IEEE Transactions on Audio and Electroacoustics = IEEE T. Acoust. Speech.
IEEE Transactions on Automatic Control = IEEE T. Automat. Contr.
IEEE Transactions on Automation Science and Engineering = IEEE T. Autom. Sci. Eng.
IEEE Transactions on Biomedical Engineering = IEEE T. Bio-Med. Eng.
IEEE Transactions on Broadcast and Television Receivers = IEEE T. Broadc. Telev.
IEEE Transactions on Broadcasting = IEEE T. Broadcast.
IEEE Transactions on Circuit Theory = IEEE T. Circuits. Syst.
IEEE Transactions on Circuits and Systems = IEEE T. Circuits. Syst.
IEEE Transactions on Circuits and Systems For Video Technology = IEEE T. Circ. Syst. Vid.
IEEE Transactions on Circuits and Systems I-Fundamental Theory and Applications = IEEE T. Circuits-I.
IEEE Transactions on Circuits and Systems I-Regular Papers = IEEE T. Circuits-I.
IEEE Transactions on Circuits and Systems Ii-Analog and Digital Signal Processing = IEEE T. Circuits-Ii.
IEEE Transactions on Circuits and Systems Ii-Express Briefs = IEEE T. Circuits-Ii.
IEEE Transactions on Communication Technology = IEEE T. Commun. Techn.
IEEE Transactions on Communication and Electronics = IEEE T. Commun. Electr.
IEEE Transactions on Communications = IEEE T. Commun.
IEEE Transactions on Communications Systems = IEEE T. Commun. Syst.
IEEE Transactions on Component Parts = IEEE T. Compon. Parts.
IEEE Transactions on Components Hybrids and Manufacturing Technology = IEEE T. Compon. Hybr.
IEEE Transactions on Components Packaging and Manufacturing Technology Part A = IEEE T. Compon. Pack. A.
IEEE Transactions on Components Packaging and Manufacturing Technology Part B-Advanced Packaging = IEEE T. Compon. Pack. B.
IEEE Transactions on Components and Packaging Technologies = IEEE T. Compon. Pack. T.
IEEE Transactions on Computer-Aided Design of Integrated Circuits and Systems = IEEE T. Comput. Aid. D.
IEEE Transactions on Computers = IEEE T. Comput.
IEEE Transactions on Consumer Electronics = IEEE T. Consum. Electr.
IEEE Transactions on Control Systems Technology = IEEE T. Contr. Syst. T.
IEEE Transactions on Dependable and Secure Computing = IEEE T. Depend. Secure.
IEEE Transactions on Device and Materials Reliability = IEEE T. Device. Mat. Re.
IEEE Transactions on Dielectrics and Electrical Insulation = IEEE T. Dielect. El. In.
IEEE Transactions on Education = IEEE T. Educ.
IEEE Transactions on Electrical Insulation = IEEE T. Electr. Insul.
IEEE Transactions on Electromagnetic Compatibility = IEEE T. Electromagn. C.
IEEE Transactions on Electron Devices = IEEE T. Electron. Dev.
IEEE Transactions on Electronic Computers = IEEE Trans. Electron.
IEEE Transactions on Electronics Packaging Manufacturing = IEEE T. Electron. Pack.
IEEE Transactions on Energy Conversion = IEEE T. Energy. Conver.
IEEE Transactions on Engineering Management = IEEE T. Eng. Manage.
IEEE Transactions on Engineering Writing and Speech = IEEE T. Prof. Commun.
IEEE Transactions on Evolutionary Computation = IEEE T. Evolut. Comput.
IEEE Transactions on Fuzzy Systems = IEEE T. Fuzzy. Syst.
IEEE Transactions on Geoscience Electronics = IEEE T. Geosci. Elect.
IEEE Transactions on Geoscience and Remote Sensing = IEEE T. Geosci. Remote.
IEEE Transactions on Human Factors in Electronics = IEEE Trans. Hum. Fact.
IEEE Transactions on Human Factors in Engineering = IEEE T. Hum. Fact. Eng.
IEEE Transactions on Image Processing = IEEE T. Image. Process.
IEEE Transactions on Industrial Electronics = IEEE T. Ind. Electron.
IEEE Transactions on Industrial Electronics and Control Instrumentation = IEEE T. Ind. El. Con. In.
IEEE Transactions on Industry Applications = IEEE T. Ind. Appl.
IEEE Transactions on Industry and General Applications = IEEE Trans. Ind. Gen. A.
IEEE Transactions on Information Technology in Biomedicine = IEEE T. Inf. Technol. B.
IEEE Transactions on Information Theory = IEEE T. Inform. Theory.
IEEE Transactions on Instrumentation and Measurement = IEEE T. Instrum. Meas.
IEEE Transactions on Intelligent Transportation Systems = IEEE T. Intell. Transp.
IEEE Transactions on Knowledge and Data Engineering = IEEE T. Knowl. Data. En.
IEEE Transactions on Magnetics = IEEE T. Magn.
IEEE Transactions on Man-Machine Systems = IEEE T. Man. Machine.
IEEE Transactions on Manufacturing Technology = IEEE T. Manuf. Tech.
IEEE Transactions on Medical Imaging = IEEE T. Med. Imaging.
IEEE Transactions on Microwave Theory and Techniques = IEEE T. Microw. Theory.
IEEE Transactions on Military Electronics = IEEE T. Mil. Electron.
IEEE Transactions on Mobile Computing = IEEE T. Mobile. Comput.
IEEE Transactions on Multimedia = IEEE T. Multimedia.
IEEE Transactions on Nanobioscience = IEEE T. Nanobiosci.
IEEE Transactions on Nanotechnology = IEEE T. Nanotechnol.
IEEE Transactions on Neural Networks = IEEE T. Neural. Networ.
IEEE Transactions on Neural Systems and Rehabilitation Engineering = IEEE T. Neur. Sys. Reh.
IEEE Transactions on Nuclear Science = IEEE T. Nucl. Sci.
IEEE Transactions on Parallel and Distributed Systems = IEEE T. Parall. Distr.
IEEE Transactions on Parts Hybrids and Packaging = IEEE T. Parts. Hyb. Pac.
IEEE Transactions on Parts Materials and Packaging = IEEE Tr. Parts. Mater.
IEEE Transactions on Pattern Analysis and Machine Intelligence = IEEE T. Pattern. Anal.
IEEE Transactions on Plasma Science = IEEE T. Plasma. Sci.
IEEE Transactions on Power Apparatus and Systems = IEEE T. Power. Ap. Syst.
IEEE Transactions on Power Delivery = IEEE T. Power. Deliver.
IEEE Transactions on Power Electronics = IEEE T. Power. Electr.
IEEE Transactions on Power Systems = IEEE T. Power. Syst.
IEEE Transactions on Product Engineering and Production = IEEE T. Prod. Eng. Prod.
IEEE Transactions on Professional Communication = IEEE T. Prof. Commun.
IEEE Transactions on Rehabilitation Engineering = IEEE T. Rehabil. Eng.
IEEE Transactions on Reliability = IEEE T. Reliab.
IEEE Transactions on Robotics = IEEE T. Robot.
IEEE Transactions on Robotics and Automation = IEEE T. Robotic. Autom.
IEEE Transactions on Semiconductor Manufacturing = IEEE T. Semiconduct. M.
IEEE Transactions on Signal Processing = IEEE T. Signal. Proces.
IEEE Transactions on Software Engineering = IEEE T. Software. Eng.
IEEE Transactions on Sonics and Ultrasonics = IEEE T. Son. Ultrason.
IEEE Transactions on Space Electronics and Telemetry = IEEE T. Space. El. Tel.
IEEE Transactions on Speech and Audio Processing = IEEE T. Speech. Audi. P.
IEEE Transactions on Systems Man and Cybernetics = IEEE T. Syst. Man. Cyb.
IEEE Transactions on Systems Man and Cybernetics Part A-Systems and Humans = IEEE T. Syst. Man. Cy. A.
IEEE Transactions on Systems Man and Cybernetics Part B-Cybernetics = IEEE T. Syst. Man. Cy. B.
IEEE Transactions on Systems Man and Cybernetics Part C-Applications and Reviews = IEEE T. Syst. Man. Cy. C.
IEEE Transactions on Systems Science and Cybernetics = IEEE T. Syst. Sci. Cyb.
IEEE Transactions on Ultrasonics Ferroelectrics and Frequency Control = IEEE T. Ultrason. Ferr.
IEEE Transactions on Vehicular Communications = IEEE T. Veh. Commun.
IEEE Transactions on Vehicular Technology = IEEE T. Veh. Technol.
IEEE Transactions on Very Large Scale Integration Vlsi Systems = IEEE T. Vlsi. Syst.
IEEE Transactions on Visualization and Computer Graphics = IEEE T. Vis. Comput. Gr.
IEEE Transactions on Wireless Communications = IEEE T. Wirel. Commun.
IEEE Vehicular Technology Group-Annual Conference = IEEE Veh. Technol. Gr.
IEEE Wireless Communications = IEEE Wirel. Commun.
IEEE-ACM Transactions on Computational Biology and Bioinformatics = IEEE-ACM T. Comput. Bi.
IEEE-ACM Transactions on Computational Biology and Bioinformatiocs = IEEE-ACM T. Comput. Bi.
IEEE-ACM Transactions on Networking = IEEE ACM T. Network.
IEEE-ASMETransactions on Mechatronics = IEEE-ASME T. Mech.
ILAR Journal = ILAR J.
ISIJ International = ISIJ Int.
IUBMB Life = IUBMB Life
Immunity = Immunity
Immunobiology = Immunobiology
Immunology = Immunology
Immunology Letters = Immunol. Lett.
Indian Chemical Engineer = Indian Chem. Eng.
Indian Journal of Biochemistry & Biophysics = Indian J. Biochem. Biophys.
Indian Journal of Chemical Technology = Indian J. Chem. Technol.
Indian Journal of Chemistry, Section B: Organic Chemistry Including Medicinal Chemistry = Indian J. Chem., Sect. B: Org. Chem. Incl. Med. Chem.
Indian Journal of Fibre & Textile Research = Indian J. Fibre Text. Res.
Indian Journal of Heterocyclic Chemistry = Indian J. Heterocycl. Chem.
Indian Journal of Physics = Indian J. Phys.
Indian Journal of Pure and Applied Physics = Indian J. Pure Appl. Phys.
Industrial & Engineering Chemistry Research = Ind. Eng. Chem. Res.
Infection and Immunity = Infect. Immun.
Inflammation Research = Inflammation Res.
Inhalation Toxicology = Inhalation Toxicol.
Inorganic Chemistry = Inorg. Chem.
Inorganic Chemistry Communications = Inorg. Chem. Commun.
Inorganic Materials = Inorg. Mater.
Inorganic Reaction Mechanisms (Philadelphia, PA, United States) = Inorg. React. Mech. (Philadelphia, PA, U. S.)
Inorganica Chimica Acta = Inorg. Chim. Acta
Insect Biochemistry and Molecular Biology = Insect Biochem. Mol. Biol.
Insect Molecular Biology = Insect Mol. Biol.
Instrumentation Science & Technology = Instrum. Sci. Technol.
Intermetallics = Intermetallics
International DATA Series, Selected Data on Mixtures, Series A: Thermodynamic Properties of Non-Reacting Binary Systems of Organic Substances = Int. DATA Ser., Sel. Data Mixtures, Ser. A
International Immunology = Int. Immunol.
International Immunopharmacology = Int. Immunopharmacol.
International Journal for Vitamin and Nutrition Research = Int. J. Vitam. Nutr. Res.
International Journal of Adhesion and Adhesives = Int. J. Adhes. Adhes.
International Journal of Antimicrobial Agents = Int. J. Antimicrob. Agents
International Journal of Applied Ceramic Technology = Int. J. Appl. Ceram. Technol.
International Journal of Biochemistry & Cell Biology = Int. J. Biochem. Cell Biol.
International Journal of Biological Macromolecules = Int. J. Biol. Macromol.
International Journal of Cancer = Int. J. Cancer
International Journal of Chemical Kinetics = Int. J. Chem. Kinet.
International Journal of Chemistry = Int. J. Chem.
International Journal of Coal Geology = Int. J. Coal Geol.
International Journal of Environment and Pollution = Int. J. Environ. Pollut.
International Journal of Environmental Analytical Chemistry = Int. J. Environ. Anal. Chem.
International Journal of Food Science and Technology = Int. J. Food Sci. Technol.
International Journal of Hydrogen Energy = Int. J. Hydrogen Energy
International Journal of Immunogenetics = Int. J. Immunogenet.
International Journal of Mass Spectrometry = Int. J. Mass Spectrom.
International Journal of Mineral Processing = Int. J. Miner. Process.
International Journal of Multiphase Flow = Int. J. Multiphase Flow
International Journal of Nanoscience = Int. J. Nanosci.
International Journal of Non-Equilibrium Processing = Int. J. Non-Equilib. Process.
International Journal of PIXE = Int. J. PIXE
International Journal of Peptide Research and Therapeutics = Int. J. Pept. Res. Ther.
International Journal of Pharmaceutics = Int. J. Pharm.
International Journal of Polymer Analysis and Characterization = Int. J. Polym. Anal. Charact.
International Journal of Polymeric Materials = Int. J. Polym. Mater.
International Journal of Powder Metallurgy (Princeton, New Jersey) = Int. J. Powder Metall. (Princeton, N. J.)
International Journal of Quantum Chemistry = Int. J. Quantum Chem.
International Journal of Radiation Biology = Int. J. Radiat. Biol.
International Journal of Refractory Metals & Hard Materials = Int. J. Refract. Met. Hard Mater.
International Journal of Thermophysics = Int. J. Thermophys.
International Materials Reviews = Int. Mater. Rev.
International Polymer Processing = Int. Polym. Process.
International Reviews in Physical Chemistry = Int. Rev. Phys. Chem.
Ionics = Ionics
Ironmaking and Steelmaking = Ironmaking Steelmaking
Isotopes in Environmental and Health Studies = Isot. Environ. Health Stud.
Israel Journal of Chemistry = Isr. J. Chem.
Italian Journal of Biochemistry = Ital. J. Biochem.
Izvestiya Natsional'noi Akademii Nauk Respubliki Kazakhstan, Seriya Khimicheskaya = Izv. Nats. Akad. Nauk Resp. Kaz., Ser. Khim.
Izvestiya Rossiiskoi Akademii Nauk, Seriya Fizicheskaya = Izv. Ross. Akad. Nauk, Ser. Fiz.
Izvestiya Vysshikh Uchebnykh Zavedenii, Khimiya i Khimicheskaya Tekhnologiya = Izv. Vyssh. Uchebn. Zaved., Khim. Khim. Tekhnol.
Izvestiya Vysshikh Uchebnykh Zavedenii, Tsvetnaya Metallurgiya = Izv. Vyssh. Uchebn. Zaved., Tsvetn. Metall.
JAMA, the Journal of the American Medical Association = JAMA, J. Am. Med. Assoc.
JBIC, Journal of Biological Inorganic Chemistry = JBIC, J. Biol. Inorg. Chem.
JCT Research = JCT Res.
JETP Letters = JETP Lett.
Japanese Journal of Applied Physics, Part 1: Regular Papers, Brief Communications & Review Papers = Jpn. J. Appl. Phys., Part 1
Japanese Journal of Applied Physics, Part 2: Letters & Express Letters = Jpn. J. Appl. Phys., Part 2
Jiegou Huaxue = Jiegou Huaxue
Jinshu Xuebao = Jinshu Xuebao
Jisuanji Yu Yingyong Huaxue = Jisuanji Yu Yingyong Huaxue
Journal - American Water Works Association = J. - Am. Water Works Assoc.
Journal de Pharmacie de Belgique = J. Pharm. Belg.
Journal of AOAC International = J. AOAC Int.
Journal of Adhesion = J. Adhes.
Journal of Adhesion Science and Technology = J. Adhes. Sci. Technol.
Journal of Advances in Chemical Physics = J. Adv. Chem. Phys.
Journal of Aerosol Science = J. Aerosol Sci.
Journal of Agricultural and Food Chemistry = J. Agric. Food Chem.
Journal of Alloys and Compounds = J. Alloys Compd.
Journal of Analytical Atomic Spectrometry = J. Anal. At. Spectrom.
Journal of Analytical Chemistry = J. Anal. Chem.
Journal of Analytical Toxicology = J. Anal. Toxicol.
Journal of Analytical and Applied Pyrolysis = J. Anal. Appl. Pyrolysis
Journal of Animal Ecology = J. Anim. Ecol.
Journal of Animal Science (Savoy, IL, United States) = J. Anim. Sci. (Savoy, IL, U. S.)
Journal of Antibiotics = J. Antibiot.
Journal of Antimicrobial Chemotherapy = J. Antimicrob. Chemother.
Journal of Applied Animal Welfare Science = J. Appl. Anim. Welfare Sci.
Journal of Applied Crystallography = J. Appl. Crystallogr.
Journal of Applied Electrochemistry = J. Appl. Electrochem.
Journal of Applied Physics = J. Appl. Phys.
Journal of Applied Polymer Science = J. Appl. Polym. Sci.
Journal of Applied Spectroscopy = J. Appl. Spectrosc.
Journal of Applied Toxicology = J. Appl. Toxicol.
Journal of Atmospheric Chemistry = J. Atmos. Chem.
Journal of Automated Methods & Management in Chemistry = J. Autom. Methods Manage. Chem.
Journal of Bacteriology = J. Bacteriol.
Journal of Biochemical and Biophysical Methods = J. Biochem. Biophys. Methods
Journal of Biochemical and Molecular Toxicology = J. Biochem. Mol. Toxicol.
Journal of Biochemistry (Tokyo, Japan) = J. Biochem. (Tokyo, Jpn.)
Journal of Biochemistry and Molecular Biology = J. Biochem. Mol. Biol.
Journal of Bioenergetics and Biomembranes = J. Bioenerg. Biomembr.
Journal of Biological Chemistry = J. Biol. Chem.
Journal of Biomaterials Science, Polymer Edition = J. Biomater. Sci., Polym. Ed.
Journal of Biomedical Materials Research, Part A = J. Biomed. Mater. Res., Part A
Journal of Biomedical Materials Research, Part B: Applied Biomaterials = J. Biomed. Mater. Res., Part B
Journal of Biomedical Nanotechnology = J. Biomed. Nanotechnol.
Journal of Biomolecular NMR = J. Biomol. NMR
Journal of Biomolecular Structure & Dynamics = J. Biomol. Struct. Dyn.
Journal of Bioscience and Bioengineering = J. Biosci. Bioeng.
Journal of Biotechnology = J. Biotechnol.
Journal of Capillary Electrophoresis and Microchip Technology = J. Capillary Electrophor. Microchip Technol.
Journal of Carbohydrate Chemistry = J. Carbohydr. Chem.
Journal of Cardiovascular Pharmacology = J. Cardiovasc. Pharmacol.
Journal of Catalysis = J. Catal.
Journal of Cell Biology = J. Cell Biol.
Journal of Cell Science = J. Cell Sci.
Journal of Cellular Biochemistry = J. Cell. Biochem.
Journal of Cellular Physiology = J. Cell. Physiol.
Journal of Chemical Crystallography = J. Chem. Crystallogr.
Journal of Chemical Ecology = J. Chem. Ecol.
Journal of Chemical Education = J. Chem. Educ.
Journal of Chemical Engineering of Japan = J. Chem. Eng. Jpn.
Journal of Chemical Information and Modeling = J. Chem. Inf. Model.
Journal of Chemical Physics = J. Chem. Phys.
Journal of Chemical Research = J. Chem. Res.
Journal of Chemical Sciences (Bangalore, India) = J. Chem. Sci. (Bangalore, India)
Journal of Chemical Technology and Biotechnology = J. Chem. Technol. Biotechnol.
Journal of Chemical Theory and Computation = J. Chem. Theory Comput.
Journal of Chemical Thermodynamics = J. Chem. Thermodyn.
Journal of Chemical and Engineering Data = J. Chem. Eng. Data
Journal of Chemometrics = J. Chemom.
Journal of Chromatographic Science = J. Chromatogr. Sci.
Journal of Chromatography, A = J. Chromatogr., A
Journal of Chromatography, B: Analytical Technologies in the Biomedical and Life Sciences = J. Chromatogr., B: Anal. Technol. Biomed. Life Sci.
Journal of Clinical Endocrinology and Metabolism = J. Clin. Endocrinol. Metab.
Journal of Clinical Investigation = J. Clin. Invest.
Journal of Cluster Science = J. Cluster Sci.
Journal of Colloid and Interface Science = J. Colloid Interface Sci.
Journal of Combinatorial Chemistry = J. Comb. Chem.
Journal of Computational Biology = J. Comput. Biol.
Journal of Computational Chemistry = J. Comput. Chem.
Journal of Computational and Theoretical Nanoscience = J. Comput. Theor. Nanosci.
Journal of Computer Chemistry, Japan = J. Comput. Chem., Jpn.
Journal of Computer-Aided Molecular Design = J. Comput.-Aided Mol. Des.
Journal of Contaminant Hydrology = J. Contam. Hydrol.
Journal of Controlled Release = J. Controlled Release
Journal of Coordination Chemistry = J. Coord. Chem.
Journal of Crystal Growth = J. Cryst. Growth
Journal of Dairy Research = J. Dairy Res.
Journal of Dairy Science = J. Dairy Sci.
Journal of Dispersion Science and Technology = J. Dispersion Sci. Technol.
Journal of Drug Targeting = J. Drug Targeting
Journal of Electroanalytical Chemistry = J. Electroanal. Chem.
Journal of Electron Spectroscopy and Related Phenomena = J. Electron Spectrosc. Relat. Phenom.
Journal of Electronic Materials = J. Electron. Mater.
Journal of Endocrinology = J. Endocrinol.
Journal of Endotoxin Research = J. Endotoxin Res.
Journal of Energetic Materials = J. Energ. Mater.
Journal of Environmental Engineering (Reston, VA, United States) = J. Environ. Eng. (Reston, VA, U. S.)
Journal of Environmental Monitoring = J. Environ. Monit.
Journal of Environmental Quality = J. Environ. Qual.
Journal of Environmental Radioactivity = J. Environ. Radioact.
Journal of Environmental Science & Engineering = J. Environ. Sci. Eng.
Journal of Environmental Science and Health, Part B: Pesticides, Food Contaminants, and Agricultural Wastes = J. Environ. Sci. Health, Part B
Journal of Enzyme Inhibition and Medicinal Chemistry = J. Enzyme Inhib. Med. Chem.
Journal of Experimental Animal Science = J. Exp. Anim. Sci.
Journal of Experimental Biology = J. Exp. Biol.
Journal of Experimental Botany = J. Exp. Bot.
Journal of Experimental Medicine = J. Exp. Med.
Journal of Experimental and Theoretical Physics = J. Exp. Theor. Phys.
Journal of Fish Biology = J. Fish Biol.
Journal of Fluorine Chemistry = J. Fluorine Chem.
Journal of Food Science = J. Food Sci.
Journal of Fusion Energy = J. Fusion Energy
Journal of General Virology = J. Gen. Virol.
Journal of General and Applied Microbiology = J. Gen. Appl. Microbiol.
Journal of Genome Science and Technology = J. Genome Sci. Technol.
Journal of Geochemical Exploration = J. Geochem. Explor.
Journal of Hazardous Materials = J. Hazard. Mater.
Journal of Heterocyclic Chemistry = J. Heterocycl. Chem.
Journal of Histochemistry and Cytochemistry = J. Histochem. Cytochem.
Journal of Hypertension = J. Hypertens.
Journal of Imaging Science and Technology = J. Imaging Sci. Technol.
Journal of Immunoassay & Immunochemistry = J. Immunoassay Immunochem.
Journal of Immunological Methods = J. Immunol. Methods
Journal of Immunology = J. Immunol.
Journal of Inclusion Phenomena and Macrocyclic Chemistry = J. Inclusion Phenom. Macrocyclic Chem.
Journal of Industrial Microbiology & Biotechnology = J. Ind. Microbiol. Biotechnol.
Journal of Industrial and Engineering Chemistry (Seoul, Republic of Korea) = J. Ind. Eng. Chem. (Seoul, Repub. Korea)
Journal of Inorganic Biochemistry = J. Inorg. Biochem.
Journal of Inorganic and Organometallic Polymers and Materials = J. Inorg. Organomet. Polym. Mater.
Journal of Insect Physiology = J. Insect Physiol.
Journal of Interferon & Cytokine Research = J. Interferon Cytokine Res.
Journal of Investigative Dermatology = J. Invest. Dermatol.
Journal of Labelled Compounds & Radiopharmaceuticals = J. Labelled Compd. Radiopharm.
Journal of Leukocyte Biology = J. Leukocyte Biol.
Journal of Lipid Research = J. Lipid Res.
Journal of Liquid Chromatography & Related Technologies = J. Liq. Chromatogr. Relat. Technol.
Journal of Low Temperature Physics = J. Low Temp. Phys.
Journal of Luminescence = J. Lumin.
Journal of Macromolecular Science, Part A: Pure and Applied Chemistry = J. Macromol. Sci., Part A: Pure Appl. Chem.
Journal of Macromolecular Science, Part B: Physics = J. Macromol. Sci., Part B: Phys.
Journal of Macromolecular Science, Polymer Reviews = J. Macromol. Sci., Polym. Rev.
Journal of Magnetic Resonance = J. Magn. Reson.
Journal of Magnetism and Magnetic Materials = J. Magn. Magn. Mater.
Journal of Mass Spectrometry = J. Mass Spectrom.
Journal of Materials Chemistry = J. Mater. Chem.
Journal of Materials Engineering and Performance = J. Mater. Eng. Perform.
Journal of Materials Research = J. Mater. Res.
Journal of Materials Science = J. Mater. Sci.
Journal of Materials Science: Materials in Electronics = J. Mater. Sci.: Mater. Electron.
Journal of Materials Science: Materials in Medicine = J. Mater. Sci.: Mater. Med.
Journal of Mathematical Chemistry = J. Math. Chem.
Journal of Medicinal Chemistry = J. Med. Chem.
Journal of Membrane Biology = J. Membr. Biol.
Journal of Membrane Science = J. Membr. Sci.
Journal of Microencapsulation = J. Microencapsulation
Journal of Modern Optics = J. Mod. Opt.
Journal of Molecular Biology = J. Mol. Biol.
Journal of Molecular Catalysis A: Chemical = J. Mol. Catal. A: Chem.
Journal of Molecular Catalysis B: Enzymatic = J. Mol. Catal. B: Enzym.
Journal of Molecular Endocrinology = J. Mol. Endocrinol.
Journal of Molecular Evolution = J. Mol. Evol.
Journal of Molecular Graphics & Modelling = J. Mol. Graphics Modell.
Journal of Molecular Liquids = J. Mol. Liq.
Journal of Molecular Microbiology and Biotechnology = J. Mol. Microbiol. Biotechnol.
Journal of Molecular Neuroscience = J. Mol. Neurosci.
Journal of Molecular Recognition = J. Mol. Recognit.
Journal of Molecular Spectroscopy = J. Mol. Spectrosc.
Journal of Molecular Structure = J. Mol. Struct.
Journal of Molecular and Cellular Cardiology = J. Mol. Cell. Cardiol.
Journal of Nanoscience and Nanotechnology = J. Nanosci. Nanotechnol.
Journal of Natural Gas Chemistry = J. Nat. Gas Chem.
Journal of Natural Products = J. Nat. Prod.
Journal of Near Infrared Spectroscopy = J. Near Infrared Spectrosc.
Journal of Neurochemistry = J. Neurochem.
Journal of Neuroendocrinology = J. Neuroendocrinol.
Journal of Neuroimmunology = J. Neuroimmunol.
Journal of Neuroscience = J. Neurosci.
Journal of Neuroscience Research = J. Neurosci. Res.
Journal of Non-Crystalline Solids = J. Non-Cryst. Solids
Journal of Non-Newtonian Fluid Mechanics = J. Non-Newtonian Fluid Mech.
Journal of Nuclear Materials = J. Nucl. Mater.
Journal of Nuclear Science and Technology (Tokyo, Japan) = J. Nucl. Sci. Technol. (Tokyo, Jpn.)
Journal of Nutrition = J. Nutr.
Journal of Nutritional Biochemistry = J. Nutr. Biochem.
Journal of Nutritional Science and Vitaminology = J. Nutr. Sci. Vitaminol.
Journal of Ocular Pharmacology and Therapeutics = J. Ocul. Pharmacol. Ther.
Journal of Oleo Science = J. Oleo Sci.
Journal of Organic Chemistry = J. Org. Chem.
Journal of Organometallic Chemistry = J. Organomet. Chem.
Journal of Peptide Research = J. Pept. Res.
Journal of Peptide Science = J. Pept. Sci.
Journal of Petroleum Science & Engineering = J. Pet. Sci. Eng.
Journal of Petrology = J. Petrol.
Journal of Pharmaceutical Sciences = J. Pharm. Sci.
Journal of Pharmaceutical and Biomedical Analysis = J. Pharm. Biomed. Anal.
Journal of Pharmacological Sciences (Tokyo, Japan) = J. Pharmacol. Sci. (Tokyo, Jpn.)
Journal of Pharmacological and Toxicological Methods = J. Pharmacol. Toxicol. Methods
Journal of Pharmacology and Experimental Therapeutics = J. Pharmacol. Exp. Ther.
Journal of Pharmacy and Pharmacology = J. Pharm. Pharmacol.
Journal of Phase Equilibria and Diffusion = J. Phase Equilib. Diffus.
Journal of Photochemistry and Photobiology, A: Chemistry = J. Photochem. Photobiol., A
Journal of Photochemistry and Photobiology, B: Biology = J. Photochem. Photobiol., B
Journal of Photochemistry and Photobiology, C: Photochemistry Reviews = J. Photochem. Photobiol., C
Journal of Photopolymer Science and Technology = J. Photopolym. Sci. Technol.
Journal of Physical Chemistry A = J. Phys. Chem. A
Journal of Physical Chemistry B = J. Phys. Chem. B
Journal of Physical Organic Chemistry = J. Phys. Org. Chem.
Journal of Physical and Chemical Reference Data = J. Phys. Chem. Ref. Data
Journal of Physics B: Atomic, Molecular and Optical Physics = J. Phys. B: At., Mol. Opt. Phys.
Journal of Physics D: Applied Physics = J. Phys. D: Appl. Phys.
Journal of Physics G: Nuclear and Particle Physics = J. Phys. G: Nucl. Part. Phys.
Journal of Physics and Chemistry of Solids = J. Phys. Chem. Solids
Journal of Physics: Condensed Matter = J. Phys.: Condens. Matter
Journal of Physiology (Oxford, United Kingdom) = J. Physiol. (Oxford, U. K.)
Journal of Pineal Research = J. Pineal Res.
Journal of Planar Chromatography--Modern TLC = J. Planar Chromatogr.--Mod. TLC
Journal of Plankton Research = J. Plankton Res.
Journal of Plant Growth Regulation = J. Plant Growth Regul.
Journal of Plant Nutrition = J. Plant Nutr.
Journal of Plant Nutrition and Soil Science = J. Plant Nutr. Soil Sci.
Journal of Plant Physiology = J. Plant Physiol.
Journal of Polymer Materials = J. Polym. Mater.
Journal of Polymer Research = J. Polym. Res.
Journal of Polymer Science, Part A: Polymer Chemistry = J. Polym. Sci., Part A: Polym. Chem.
Journal of Polymer Science, Part B: Polymer Physics = J. Polym. Sci., Part B: Polym. Phys.
Journal of Polymers and the Environment = J. Polym. Environ.
Journal of Porphyrins and Phthalocyanines = J. Porphyrins Phthalocyanines
Journal of Power Sources = J. Power Sources
Journal of Process Control = J. Process Control
Journal of Proteome Research = J. Proteome Res.
Journal of Pulp and Paper Science = J. Pulp Pap. Sci.
Journal of Quantitative Spectroscopy & Radiative Transfer = J. Quant. Spectrosc. Radiat. Transfer
Journal of Radioanalytical and Nuclear Chemistry = J. Radioanal. Nucl. Chem.
Journal of Raman Spectroscopy = J. Raman Spectrosc.
Journal of Receptors and Signal Transduction = J. Recept. Signal Transduction
Journal of Reinforced Plastics and Composites = J. Reinf. Plast. Compos.
Journal of Rheology (New York, NY, United States) = J. Rheol. (N. Y., NY, U. S.)
Journal of Separation Science = J. Sep. Sci.
Journal of Sol-Gel Science and Technology = J. Sol-Gel Sci. Technol.
Journal of Solid State Chemistry = J. Solid State Chem.
Journal of Solid State Electrochemistry = J. Solid State Electrochem.
Journal of Solution Chemistry = J. Solution Chem.
Journal of Steroid Biochemistry and Molecular Biology = J. Steroid Biochem. Mol. Biol.
Journal of Structural Chemistry = J. Struct. Chem.
Journal of Structural and Functional Genomics = J. Struct. Funct. Genomics
Journal of Sulfur Chemistry = J. Sulfur Chem.
Journal of Superconductivity = J. Supercond.
Journal of Supercritical Fluids = J. Supercrit. Fluids
Journal of Surfactants and Detergents = J. Surfactants Deterg.
Journal of The American Statistical Association = J. Am. Stat. Assoc.
Journal of Theoretical & Computational Chemistry = J. Theor. Comput. Chem.
Journal of Theoretical Biology = J. Theor. Biol.
Journal of Thermal Analysis and Calorimetry = J. Therm. Anal. Calorim.
Journal of Thermophysics and Heat Transfer = J. Thermophys. Heat Transfer
Journal of Toxicology and Environmental Health, Part A = J. Toxicol. Environ. Health, Part A
Journal of Toxicology and Environmental Health, Part B: Critical Reviews = J. Toxicol. Environ. Health, Part B
Journal of Vacuum Science & Technology, A: Vacuum, Surfaces, and Films = J. Vac. Sci. Technol., A
Journal of Vinyl & Additive Technology = J. Vinyl Addit. Technol.
Journal of Virological Methods = J. Virol. Methods
Journal of Virology = J. Virol.
Journal of Volcanology and Geothermal Research = J. Volcanol. Geotherm. Res.
Journal of Wood Chemistry and Technology = J. Wood Chem. Technol.
Journal of the American Ceramic Society = J. Am. Ceram. Soc.
Journal of the American Chemical Society = J. Am. Chem. Soc.
Journal of the American Oil Chemists' Society = J. Am. Oil Chem. Soc.
Journal of the American Society for Mass Spectrometry = J. Am. Soc. Mass Spectrom.
Journal of the American Society of Brewing Chemists = J. Am. Soc. Brew. Chem.
Journal of the Argentine Chemical Society = J. Argent. Chem. Soc.
Journal of the Brazilian Chemical Society = J. Braz. Chem. Soc.
Journal of the Ceramic Society of Japan = J. Ceram. Soc. Jpn.
Journal of the Chemical Society of Pakistan = J. Chem. Soc. Pak.
Journal of the Chilean Chemical Society = J. Chil. Chem. Soc.
Journal of the Chinese Chemical Society (Taipei, Taiwan) = J. Chin. Chem. Soc. (Taipei, Taiwan)
Journal of the Chinese Institute of Chemical Engineers = J. Chin. Inst. Chem. Eng.
Journal of the Electrochemical Society = J. Electrochem. Soc.
Journal of the Electrochemical Society of India = J. Electrochem. Soc. India
Journal of the Energy Institute = J. Energy Inst.
Journal of the European Ceramic Society = J. Eur. Ceram. Soc.
Journal of the Indian Chemical Society = J. Indian Chem. Soc.
Journal of the Institution of Chemists (India) = J. Inst. Chem. (India)
Journal of the Japan Petroleum Institute = J. Jpn. Pet. Inst.
Journal of the Korean Ceramic Society = J. Korean Ceram. Soc.
Journal of the Korean Chemical Society = J. Korean Chem. Soc.
Journal of the Marine Biology Association of the United Kingdom = J. mar. biol. Ass. U.K.
Journal of the Optical Society of America B: Optical Physics = J. Opt. Soc. Am. B
Journal of the Physical Society of Japan = J. Phys. Soc. Jpn.
Journal of the Science of Food and Agriculture = J. Sci. Food Agric.
Journal of the Serbian Chemical Society = J. Serb. Chem. Soc.
Journal of the Society of Inorganic Materials, Japan = J. Soc. Inorg. Mater., Jpn.
Journal of the World Aquaculture Society = J. World Aquacult. Soc.
KGK, Kautschuk Gummi Kunststoffe = KGK, Kautsch. Gummi Kunstst.
Kagaku Kogaku = Kagaku Kogaku
Kagaku Kogaku Ronbunshu = Kagaku Kogaku Ronbunshu
Kemija u Industriji = Kem. Ind.
Khimicheskaya Promyshlennost (St. Petersburg, Russian Federation) = Khim. Prom-st. (St. Petersburg, Russ. Fed.)
Khimicheskaya Promyshlennost Segodnya = Khim. Prom-st. Segodnya
Khimiya Tverdogo Topliva (Moscow, Russian Federation) = Khim. Tverd. Topl. (Moscow, Russ. Fed.)
Khimiya i Tekhnologiya Vody = Khim. Tekhnol. Vody
Khimiya v Interesakh Ustoichivogo Razvitiya = Khim. Interesakh Ustoich. Razvit.
Kinetics and Catalysis = Kinet. Catal.
Kobunshi Ronbunshu = Kobunshi Ronbunshu
Koks i Khimiya = Koks Khim.
Korean Journal of Chemical Engineering = Korean J. Chem. Eng.
LCGC North America = LCGC North Am.
LWT--Food Science and Technology = LWT--Food Sci. Technol.
Lab on a Chip = Lab Chip
Laboratory Animals = Lab. Anim.
Langmuir = Langmuir
Laser and Particle Beams = Laser Part. Beams
Latvijas Kimijas Zurnals = Latv. Kim. Z.
Letters in Drug Design & Discovery = Lett. Drug Des. Discovery
Letters in Organic Chemistry = Lett. Org. Chem.
Life Sciences = Life Sci.
Limnology and Oceanography = Limnol. Oceanogr.
Linchan Huaxue Yu Gongye = Linchan Huaxue Yu Gongye
Lipids = Lipids
Liquid Crystals = Liq. Cryst.
Lithos = Lithos
Macromolecular Bioscience = Macromol. Biosci.
Macromolecular Chemistry and Physics = Macromol. Chem. Phys.
Macromolecular Materials and Engineering = Macromol. Mater. Eng.
Macromolecular Rapid Communications = Macromol. Rapid Commun.
Macromolecular Research = Macromol. Res.
Macromolecular Symposia = Macromol. Symp.
Macromolecular Theory and Simulations = Macromol. Theory Simul.
Macromolecules = Macromolecules
Magnesium Research = Magnesium Res.
Magnetic Resonance in Chemistry = Magn. Reson. Chem.
Magyar Kemiai Folyoirat, Kemiai Kozlemenyek = Magy. Kem. Foly., Kem. Kozl.
Main Group Metal Chemistry = Main Group Met. Chem.
Marine & Freshwater Research = Mar. Freshwater Res.
Marine Biology = Mar. Biol.
Marine Biotechnology = Mar. Biotechnol.
Marine Chemistry = Mar. Chem.
Marine Ecology Progress Series = Mar. Ecol. Prog. Ser.
Marine Environmental Research = Mar. Environ. Res.
Marine Pollution Bulletin = Mar. Pollut. Bull.
Materials Characterization = Mater. Charact.
Materials Chemistry and Physics = Mater. Chem. Phys.
Materials Forum = Mater. Forum
Materials Letters = Mater. Lett.
Materials Research Bulletin = Mater. Res. Bull.
Materials Research Innovations = Mater. Res. Innovations
Materials Research Society Symposium Proceedings = Mater. Res. Soc. Symp. Proc.
Materials Science & Engineering, A: Structural Materials: Properties, Microstructure and Processing = Mater. Sci. Eng., A
Materials Science & Engineering, B: Solid-State Materials for Advanced Technology = Mater. Sci. Eng., B
Materials Science & Engineering, C: Biomimetic and Supramolecular Systems = Mater. Sci. Eng., C
Materials Science and Technology = Mater. Sci. Technol.
Materials Science in Semiconductor Processing = Mater. Sci. Semicond. Process.
Materials Transactions = Mater. Trans.
Materials and Corrosion = Mater. Corros.
Materials and Manufacturing Processes = Mater. Manuf. Processes
Mathematical Biosciences = Math. Biosci.
Matrix Biology = Matrix Biol.
Measurement Science and Technology = Meas. Sci. Technol.
Mechanisms of Development = Mech. Dev.
Medicinal Chemistry = Med. Chem.
Medicinal Chemistry Research = Med. Chem. Res.
Mendeleev Communications = Mendeleev Commun.
Metabolic Engineering = Metab. Eng.
Metabolism, Clinical and Experimental = Metab., Clin. Exp.
Metal Science and Heat Treatment = Met. Sci. Heat Treat.
Metallofizika i Noveishie Tekhnologii = Metallofiz. Noveishie Tekhnol.
Metallurgical and Materials Transactions A: Physical Metallurgy and Materials Science = Metall. Mater. Trans. A
Metallurgical and Materials Transactions B: Process Metallurgy and Materials Processing Science = Metall. Mater. Trans. B
Metally = Metally
Meteoritics & Planetary Science = Meteorit. Planet. Sci.
Methods (San Diego, CA, United States) = Methods (San Diego, CA, U. S.)
Microbiology (New York, NY, United States) = Microbiology (N. Y., NY, U. S.)
Microbiology (Reading, United Kingdom) = Microbiology (Reading, U. K.)
Microbiology and Immunology = Microbiol. Immunol.
Microchemical Journal = Microchem. J.
Microchimica Acta = Microchim. Acta
Microelectronic Engineering = Microelectron. Eng.
Microporous and Mesoporous Materials = Microporous Mesoporous Mater.
Microscopy and Microanalysis = Microsc. Microanal.
Milchwissenschaft = Milchwissenschaft
Mineralium Deposita = Miner. Deposita
Mineralogical Magazine = Mineral. Mag.
Mineralogy and Petrology = Mineral. Petrol.
Minerals & Metallurgical Processing = Miner. Metall. Process.
Minerals Engineering = Miner. Eng.
Mini-Reviews in Medicinal Chemistry = Mini-Rev. Med. Chem.
Mini-Reviews in Organic Chemistry = Mini-Rev. Org. Chem.
Mitochondrion = Mitochondrion
Modern Physics Letters B = Mod. Phys. Lett. B
Molecular BioSystems = Mol. BioSyst.
Molecular Biology (New York, NY, United States, English Edition) = Mol. Biol. (N. Y., NY, U. S., Engl. Ed.)
Molecular Biology Reports = Mol. Biol. Rep.
Molecular Biology and Evolution = Mol. Biol. Evol.
Molecular Biology of the Cell = Mol. Biol. Cell
Molecular Biotechnology = Mol. Biotechnol.
Molecular Brain Research = Mol. Brain Res.
Molecular Cancer Research = Mol. Cancer Res.
Molecular Cancer Therapeutics = Mol. Cancer Ther.
Molecular Carcinogenesis = Mol. Carcinog.
Molecular Cell = Mol. Cell
Molecular Crystals and Liquid Crystals = Mol. Cryst. Liq. Cryst.
Molecular Diversity = Mol. Diversity
Molecular Endocrinology = Mol. Endocrinol.
Molecular Genetics and Genomics = Mol. Genet. Genomics
Molecular Genetics and Metabolism = Mol. Genet. Metab.
Molecular Immunology = Mol. Immunol.
Molecular Membrane Biology = Mol. Membr. Biol.
Molecular Microbiology = Mol. Microbiol.
Molecular Neurobiology = Mol. Neurobiol.
Molecular Pharmaceutics = Mol. Pharm.
Molecular Pharmacology = Mol. Pharmacol.
Molecular Physics = Mol. Phys.
Molecular Plant-Microbe Interactions = Mol. Plant-Microbe Interact.
Molecular Reproduction and Development = Mol. Reprod. Dev.
Molecular Simulation = Mol. Simul.
Molecular Therapy = Mol. Ther.
Molecular and Biochemical Parasitology = Mol. Biochem. Parasitol.
Molecular and Cellular Biochemistry = Mol. Cell. Biochem.
Molecular and Cellular Biology = Mol. Cell. Biol.
Molecular and Cellular Endocrinology = Mol. Cell. Endocrinol.
Molecular and Cellular Neuroscience = Mol. Cell. Neurosci.
Molecular and Cellular Probes = Mol. Cell. Probes
Molecular and Cellular Proteomics = Mol. Cell. Proteomics
Molecules = Molecules
Molecules and Cells = Mol. Cells
Monatshefte fuer Chemie = Monatsh. Chem.
Mucopolysaccharides Biochimica et Biophysica Acta, Specialized Section on Mucoproteins and Mucopolysaccharides = Biochim. Biophys. Acta, Spec. Sect. Mucoproteins
Mutagenesis = Mutagenesis
Mutation Research = Mutat. Res.
Nano Letters = Nano Lett.
NanoBiotechnology = NanoBiotechnology
Nanomedicine = Nanomedicine
Natural Product Reports = Nat. Prod. Rep.
Natural Product Research = Nat. Prod. Res.
Natural Product Sciences = Nat. Prod. Sci.
Nature (London, United Kingdom) = Nature (London, U. K.)
Nature Biotechnology = Nat. Biotechnol.
Nature Cell Biology = Nat. Cell Biol.
Nature Chemical Biology = Nat. Chem. Biol.
Nature Genetics = Nat. Genet.
Nature Immunology = Nat. Immunol.
Nature Materials = Nat. Mater.
Nature Medicine (New York, NY, United States) = Nat. Med. (N. Y., NY, U. S.)
Nature Methods = Nat. Methods
Nature Neuroscience = Nat. Neurosci.
Nature Reviews Cancer = Nat. Rev. Cancer
Nature Reviews Drug Discovery = Nat. Rev. Drug Discovery
Nature Reviews Genetics = Nat. Rev. Genet.
Nature Reviews Immunology = Nat. Rev. Immunol.
Nature Reviews Microbiology = Nat. Rev. Microbiol.
Nature Reviews Molecular Cell Biology = Nat. Rev. Mol. Cell Biol.
Nature Reviews Neuroscience = Nat. Rev. Neurosci.
Nature Structural & Molecular Biology = Nat. Struct. Mol. Biol.
Naturwissenschaften = Naturwissenschaften
Naunyn-Schmiedeberg's Archives of Pharmacology = Naunyn-Schmiedeberg's Arch. Pharmacol.
Neftekhimiya = Neftekhimiya
Neues Jahrbuch fuer Mineralogie, Abhandlungen = Neues Jahrb. Mineral., Abh.
NeuroImmunoModulation = NeuroImmunoModulation
NeuroMolecular Medicine = NeuroMol. Med.
Neurochemical Research = Neurochem. Res.
Neurochemistry International = Neurochem. Int.
Neuroendocrinology = Neuroendocrinology
Neuron = Neuron
Neuropeptides (Amsterdam, Netherlands) = Neuropeptides (Amsterdam, Neth.)
Neuropharmacology = Neuropharmacology
Neuroscience (Oxford, United Kingdom) = Neuroscience (Oxford, U. K.)
Neuroscience Letters = Neurosci. Lett.
Neurosignals = Neurosignals
Neurotoxicology and Teratology = Neurotoxicol. Teratol.
New Diamond and Frontier Carbon Technology = New Diamond Front. Carbon Technol.
New England Journal of Medicine = N. Engl. J. Med.
New Journal of Chemistry = New J. Chem.
Nihon Reoroji Gakkaishi = Nihon Reoroji Gakkaishi
Nippon Kinzoku Gakkaishi = Nippon Kinzoku Gakkaishi
Nitric Oxide = Nitric Oxide
Nordic Pulp & Paper Research Journal = Nord. Pulp Pap. Res. J.
Nuclear Engineering and Design = Nucl. Eng. Des.
Nuclear Fusion = Nucl. Fusion
Nuclear Instruments & Methods in Physics Research, Section A: Accelerators, Spectrometers, Detectors, and Associated Equipment = Nucl. Instrum. Methods Phys. Res., Sect. A
Nuclear Instruments & Methods in Physics Research, Section B: Beam Interactions with Materials and Atoms = Nucl. Instrum. Methods Phys. Res., Sect. B
Nuclear Medicine and Biology = Nucl. Med. Biol.
Nuclear Physics A = Nucl. Phys. A
Nuclear Physics B = Nucl. Phys. B
Nuclear Physics B, Proceedings Supplements = Nucl. Phys. B, Proc. Suppl.
Nuclear Science and Engineering = Nucl. Sci. Eng.
Nuclear Technology = Nucl. Technol.
Nucleic Acids Research = Nucleic Acids Res.
Nucleic Acids Research Supplement = Nucleic Acids Res. Suppl.
Nucleosides, Nucleotides & Nucleic Acids = Nucleosides, Nucleotides Nucleic Acids
Nukleonika = Nukleonika
Nutrition Research (New York, NY, United States) = Nutr. Res. (N. Y., NY, U. S.)
O'zbekiston Kimyo Jurnali = O'zb. Kim. J.
OMICS = OMICS
Oil, Gas (Hamburg, Germany) = Oil, Gas (Hamburg, Ger.)
Oligonucleotides = Oligonucleotides
Oncogene = Oncogene
Optical Engineering = Opt. Eng.
Optical and Quantum Electronics = Opt. Quantum. Electron.
Optics Communications = Opt. Commun.
Optics Express = Opt. Express
Optics Letters = Opt. Lett.
Optics and Spectroscopy = Opt. Spectrosc.
Organic & Biomolecular Chemistry = Org. Biomol. Chem.
Organic Geochemistry = Org. Geochem.
Organic Letters = Org. Lett.
Organic Preparations and Procedures International = Org. Prep. Proced. Int.
Organic Process Research & Development = Org. Process Res. Dev.
Organic Syntheses = Org. Synth.
Organometallics = Organometallics
Oriental Journal of Chemistry = Orient. J. Chem.
Oxidation Communications = Oxid. Commun.
Oxidation of Metals = Oxid. Met.
Oyo Yakuri = Oyo Yakuri
Ozone: Science & Engineering = Ozone: Sci. Eng.
PLoS Biology = PLoS Biol.
PLoS Computational Biology = PLoS Comput. Biol.
PLoS Genetics = PLoS Genet.
PMSE Preprints = PMSE Prepr.
Particulate Science and Technology = Part. Sci. Technol.
Peptides (New York, NY, United States) = Peptides (N. Y., NY, U. S.)
Pest Management Science = Pest Manage. Sci.
Pesticide Biochemistry and Physiology = Pestic. Biochem. Physiol.
Petroleum Science and Technology = Pet. Sci. Technol.
Pfluegers Archiv = Pfluegers Arch.
Pharmaceutical Chemistry Journal = Pharm. Chem. J.
Pharmaceutical Development and Technology = Pharm. Dev. Technol.
Pharmaceutical Research = Pharm. Res.
Pharmacogenetics and Genomics = Pharmacogenet. Genomics
Pharmacogenomics Journal = Pharmacogenomics J.
Pharmacology = Pharmacology
Pharmacology & Therapeutics = Pharmacol. Ther.
Pharmacology, Biochemistry and Behavior = Pharmacol., Biochem. Behav.
Pharmazie = Pharmazie
Phase Transitions = Phase Transitions
Philosophical Magazine = Philos. Mag.
Philosophical Magazine Letters = Philos. Mag. Lett.
Phosphorus, Sulfur and Silicon and the Related Elements = Phosphorus, Sulfur Silicon Relat. Elem.
Photochemical & Photobiological Sciences = Photochem. Photobiol. Sci.
Photochemistry and Photobiology = Photochem. Photobiol.
Photosynthesis Research = Photosynth. Res.
Physica B: Condensed Matter (Amsterdam, Netherlands) = Physica B (Amsterdam, Neth.)
Physica C: Superconductivity and Its Applications (Amsterdam, Netherlands) = Physica C (Amsterdam, Neth.)
Physica Scripta = Phys. Scr.
Physica Scripta, T = Phys. Scr., T
Physica Status Solidi A: Applications and Materials Science = Phys. Status Solidi A
Physica Status Solidi B: Basic Solid State Physics = Phys. Status Solidi B
Physica Status Solidi C: Conferences and Critical Reviews = Phys. Status Solidi C
Physical Chemistry Chemical Physics = Phys. Chem. Chem. Phys.
Physical Review A: Atomic, Molecular, and Optical Physics = Phys. Rev. A: At., Mol., Opt. Phys.
Physical Review B: Condensed Matter and Materials Physics = Phys. Rev. B: Condens. Matter Mater. Phys.
Physical Review C: Nuclear Physics = Phys. Rev. C: Nucl. Phys.
Physical Review D: Particles and Fields = Phys. Rev. D: Part. Fields
Physical Review E: Statistical, Nonlinear, and Soft Matter Physics = Phys. Rev. E: Stat., Nonlinear, Soft Matter Phys.
Physical Review Letters = Phys. Rev. Lett.
Physics Letters A = Phys. Lett. A
Physics Letters B = Phys. Lett. B
Physics and Chemistry of Glasses = Phys. Chem. Glasses
Physics and Chemistry of Liquids = Phys. Chem. Liq.
Physics and Chemistry of Minerals = Phys. Chem. Miner.
Physics of Atomic Nuclei = Phys. At. Nucl.
Physics of Fluids = Phys. Fluids
Physics of Plasmas = Phys. Plasmas
Physics of the Solid State = Phys. Solid State
Physiologia Plantarum = Physiol. Plant.
Physiology & Behavior = Physiol. Behav.
Phytochemical Analysis = Phytochem. Anal.
Phytochemistry (Elsevier) = Phytochemistry (Elsevier)
Phytochemistry Reviews = Phytochem. Rev.
Plant Cell = Plant Cell
Plant Cell Reports = Plant Cell Rep.
Plant Growth Regulation = Plant Growth Regul.
Plant Journal = Plant J.
Plant Molecular Biology = Plant Mol. Biol.
Plant Physiology = Plant Physiol.
Plant Physiology and Biochemistry (Amsterdam, Netherlands) = Plant Physiol. Biochem. (Amsterdam, Neth.)
Plant Science (Amsterdam, Netherlands) = Plant Sci. (Amsterdam, Neth.)
Plant and Cell Physiology = Plant Cell Physiol.
Plant and Soil = Plant Soil
Planta = Planta
Planta Medica = Planta Med.
Plasma Chemistry and Plasma Processing = Plasma Chem. Plasma Process.
Plasma Processes and Polymers = Plasma Processes Polym.
Plasmid = Plasmid
Plasticheskie Massy = Plast. Massy
Plastics, Rubber and Composites = Plast., Rubber Compos.
Platelets = Platelets
Polish Journal of Chemistry = Pol. J. Chem.
Polycyclic Aromatic Compounds = Polycyclic Aromat. Compd.
Polyhedron = Polyhedron
Polymer = Polymer
Polymer (Korea) = Polymer (Korea)
Polymer Bulletin (Heidelberg, Germany) = Polym. Bull. (Heidelberg, Ger.)
Polymer Composites = Polym. Compos.
Polymer Degradation and Stability = Polym. Degrad. Stab.
Polymer Engineering and Science = Polym. Eng. Sci.
Polymer International = Polym. Int.
Polymer Journal (Tokyo, Japan) = Polym. J. (Tokyo, Jpn.)
Polymer Preprints (American Chemical Society, Division of Polymer Chemistry) = Polym. Prepr. (Am. Chem. Soc., Div. Polym. Chem.)
Polymer Testing = Polym. Test.
Polymer-Plastics Technology and Engineering = Polym.-Plast. Technol. Eng.
Polymers & Polymer Composites = Polym. Polym. Compos.
Polymers for Advanced Technologies = Polym. Adv. Technol.
Poverkhnost = Poverkhnost
Powder Diffraction = Powder Diffr.
Powder Metallurgy = Powder Metall.
Powder Metallurgy and Metal Ceramics = Powder Metall. Met. Ceram.
Powder Technology = Powder Technol.
Practical Spectroscopy = Pract. Spectrosc.
Precambrian Research = Precambrian Res.
Preparative Biochemistry & Biotechnology = Prep. Biochem. Biotechnol.
Preprints - American Chemical Society, Division of Petroleum Chemistry = Prepr. - Am. Chem. Soc., Div. Pet. Chem.
Preprints of Symposia - American Chemical Society, Division of Fuel Chemistry = Prepr. Symp. - Am. Chem. Soc., Div. Fuel Chem.
Proceedings - Electrochemical Society = Proc. - Electrochem. Soc.
Proceedings of the Estonian Academy of Sciences, Chemistry = Proc. Est. Acad. Sci., Chem.
Proceedings of the National Academy of Sciences of the United States of America = Proc. Natl. Acad. Sci. U. S. A.
Process Biochemistry (Oxford, United Kingdom) = Process Biochem. (Oxford, U. K.)
Process Safety and Environmental Protection = Process Saf. Environ. Prot.
Progress in Colloid & Polymer Science = Prog. Colloid Polym. Sci.
Progress in Crystal Growth and Characterization of Materials = Prog. Cryst. Growth Charact. Mater.
Progress in Inorganic Chemistry = Prog. Inorg. Chem.
Progress in Nuclear Magnetic Resonance Spectroscopy = Prog. Nucl. Magn. Reson. Spectrosc.
Progress in Organic Coatings = Prog. Org. Coat.
Progress in Polymer Science = Prog. Polym. Sci.
Progress in Reaction Kinetics and Mechanism = Prog. React. Kinet. Mech.
Progress in Solid State Chemistry = Prog. Solid State Chem.
Progress in Surface Science = Prog. Surf. Sci.
Propellants, Explosives, Pyrotechnics = Propellants, Explos., Pyrotech.
Prostaglandins & Other Lipid Mediators = Prostaglandins Other Lipid Mediators
Prostaglandins, Leukotrienes and Essential Fatty Acids = Prostaglandins, Leukotrienes Essent. Fatty Acids
Protection of Metals = Prot. Met.
Protein Engineering, Design & Selection = Protein Eng., Des. Sel.
Protein Expression and Purification = Protein Expression Purif.
Protein Journal = Protein J.
Protein Science = Protein Sci.
Protein and Peptide Letters = Protein Pept. Lett.
Proteins: Structure, Function, and Bioinformatics = Proteins: Struct., Funct., Bioinf.
Proteomics = Proteomics
Przemysl Chemiczny = Przem. Chem.
Psychopharmacology (Berlin, Germany) = Psychopharmacology (Berlin, Ger.)
Pteridines = Pteridines
Pulmonary Pharmacology & Therapeutics = Pulm. Pharmacol. Ther.
Pure and Applied Chemistry = Pure Appl. Chem.
Purinergic Signalling = Purinergic Signalling
QSAR & Combinatorial Science = QSAR Comb. Sci.
Quantum Electronics = Quantum Electron.
Quimica Nova = Quim. Nova
RNA = RNA
RNA Biology = RNA Biol.
Radiation Effects and Defects in Solids = Radiat. Eff. Defects Solids
Radiation Measurements = Radiat. Meas.
Radiation Physics and Chemistry = Radiat. Phys. Chem.
Radiation Research = Radiat. Res.
Radiochemistry (New York, NY, United States) = Radiochemistry (N. Y., NY, U. S.)
Radiochimica Acta = Radiochim. Acta
Radioprotection = Radioprotection
Ranliao Huaxue Xuebao = Ranliao Huaxue Xuebao
Rapid Communications in Mass Spectrometry = Rapid Commun. Mass Spectrom.
Rare Metals (Beijing, China) = Rare Met. (Beijing, China)
Rasplavy = Rasplavy
Reaction Kinetics and Catalysis Letters = React. Kinet. Catal. Lett.
Reactive & Functional Polymers = React. Funct. Polym.
Regulatory Peptides = Regul. Pept.
Rengong Jingti Xuebao = Rengong Jingti Xuebao
Reproduction (Bristol, United Kingdom) = Reproduction (Bristol, U. K.)
Reproductive Toxicology = Reprod. Toxicol.
Research Communications in Biochemistry and Cell & Molecular Biology = Res. Commun. Biochem. Cell Mol. Biol.
Research Communications in Molecular Pathology and Pharmacology = Res. Commun. Mol. Pathol. Pharmacol.
Research Communications in Pharmacology and Toxicology = Res. Commun. Pharmacol. Toxicol.
Research on Chemical Intermediates = Res. Chem. Intermed.
Review of Scientific Instruments = Rev. Sci. Instrum.
Reviews in Analytical Chemistry = Rev. Anal. Chem.
Reviews in Inorganic Chemistry = Rev. Inorg. Chem.
Revista Mexicana de Ingenieria Quimica = Rev. Mex. Ing. Quim.
Revista Romana de Materiale = Rev. Rom. Mater.
Revista de Chimie (Bucharest, Romania) = Rev. Chim. (Bucharest, Rom.)
Revista de la Sociedad Quimica del Peru = Rev. Soc. Quim. Peru
Revue Roumaine de Chimie = Rev. Roum. Chim.
Rheologica Acta = Rheol. Acta
Romanian Journal of Physics = Rom. J. Phys.
Rossiiskii Khimicheskii Zhurnal = Ross. Khim. Zh.
Rubber Chemistry and Technology = Rubber Chem. Technol.
Russian Chemical Bulletin = Russ. Chem. Bull.
Russian Chemical Reviews = Russ. Chem. Rev.
Russian Journal of Applied Chemistry = Russ. J. Appl. Chem.
Russian Journal of Bioorganic Chemistry = Russ. J. Bioorg. Chem.
Russian Journal of Coordination Chemistry = Russ. J. Coord. Chem.
Russian Journal of Electrochemistry = Russ. J. Electrochem.
Russian Journal of General Chemistry = Russ. J. Gen. Chem.
Russian Journal of Genetics = Russ. J. Genet.
Russian Journal of Organic Chemistry = Russ. J. Org. Chem.
Russian Journal of Physical Chemistry = Russ. J. Phys. Chem.
Russian Journal of Plant Physiology = Russ. J. Plant Physiol.
SAR and QSAR in Environmental Research = SAR QSAR Environ. Res.
SPE Production & Facilities = SPE Prod. Facil.
SPE Reservoir Evaluation & Engineering = SPE Reservoir Eval. Eng.
STAL, Sciences et Techniques de l'Animal de Laboratoire = STAL, Sci. Tech. Anim. Lab.
Scandinavian Journal of Laboratory Animal Science = Scand. J. Lab. Anim. Sci.
Scandinavian Journal of Metallurgy = Scand. J. Metall.
Science (Washington, DC, United States) = Science (Washington, DC, U. S.)
Science in China, Series B: Chemistry = Sci. China, Ser. B: Chem.
Science of the Total Environment = Sci. Total Environ.
Scripta Materialia = Scr. Mater.
Seibutsu Kogaku Kaishi = Seibutsu Kogaku Kaishi
Semiconductor Science and Technology = Semicond. Sci. Technol.
Semiconductors = Semiconductors
Sensors and Actuators, A: Physical = Sens. Actuators, A
Sensors and Actuators, B: Chemical = Sens. Actuators, B
Separation Science and Technology = Sep. Sci. Technol.
Separation and Purification Technology = Sep. Purif. Technol.
Sepu = Sepu
Shiyou Huagong = Shiyou Huagong
Shiyou Xuebao, Shiyou Jiagong = Shiyou Xuebao, Shiyou Jiagong
Shuichuli Jishu = Shuichuli Jishu
Signal Transduction = Signal Transduction
Silicon Chemistry = Silicon Chem.
Small = Small
Soft Matter = Soft Matter
Soil Biology & Biochemistry = Soil Biol. Biochem.
Soil Science = Soil Sci.
Soil Science Society of America Journal = Soil Sci. Soc. Am. J.
Solar Energy Materials & Solar Cells = Sol. Energy Mater. Sol. Cells
Solid State Communications = Solid State Commun.
Solid State Ionics = Solid State Ionics
Solid State Nuclear Magnetic Resonance = Solid State Nucl. Magn. Reson.
Solid State Sciences = Solid State Sci.
Solid-State Electronics = Solid-State Electron.
Solvent Extraction Research and Development, Japan = Solvent Extr. Res. Dev., Jpn.
Solvent Extraction and Ion Exchange = Solvent Extr. Ion Exch.
Somatic Cell and Molecular Genetics = Somatic Cell Mol. Genet.
South African Journal of Chemistry = S. Afr. J. Chem.
Spectrochimica Acta, Part A: Molecular and Biomolecular Spectroscopy = Spectrochim. Acta, Part A
Spectrochimica Acta, Part B: Atomic Spectroscopy = Spectrochim. Acta, Part B
Spectroscopy (Amsterdam, Netherlands) = Spectroscopy (Amsterdam, Neth.)
Spectroscopy Letters = Spectrosc. Lett.
Starch/Staerke = Starch/Staerke
Steel Research International = Steel Res. Int.
Steroids = Steroids
Struct.--Process., Meas., Phenom. Journal of Vacuum Science & Technology, B: Microelectronics and Nanometer Structures--Processing, Measurement, and Phenomena = J. Vac. Sci. Technol., B: Microelectron. Nanometer
Structural Chemistry = Struct. Chem.
Structure (Cambridge, MA, United States) = Structure (Cambridge, MA, U. S.)
Subj. Biochimica et Biophysica Acta, Specialized Section on Nucleic Acids and Related Subjects = Biochim. Biophys. Acta, Spec. Sect. Nucleic Acids Relat.
Superconductor Science and Technology = Supercond. Sci. Technol.
Superlattices and Microstructures = Superlattices Microstruct.
Supramolecular Chemistry = Supramol. Chem.
Surface Engineering = Surf. Eng.
Surface Review and Letters = Surf. Rev. Lett.
Surface Science = Surf. Sci.
Surface Science Reports = Surf. Sci. Rep.
Surface and Coatings Technology = Surf. Coat. Technol.
Surface and Interface Analysis = Surf. Interface Anal.
Synapse (New York, NY, United States) = Synapse (N. Y., NY, U. S.)
Synlett = Synlett
Synthesis = Synthesis
Synthesis and Reactivity in Inorganic, Metal-Organic, and Nano-Metal Chemistry = Synth. React. Inorg., Met.-Org., Nano-Met. Chem.
Synthetic Communications = Synth. Commun.
Synthetic Lubrication = Synth. Lubr.
Synthetic Metals = Synth. Met.
THEOCHEM = THEOCHEM
Taehan Kumsok, Chaeryo Hakhoechi = Taehan Kumsok, Chaeryo Hakhoechi
Talanta = Talanta
Tappi Journal = Tappi J.
Technical Physics = Tech. Phys.
Technical Physics Letters = Tech. Phys. Lett.
Tenside, Surfactants, Detergents = Tenside, Surfactants, Deterg.
Tetrahedron = Tetrahedron
Tetrahedron Letters = Tetrahedron Lett.
Tetrahedron: Asymmetry = Tetrahedron: Asymmetry
Tetsu to Hagane = Tetsu to Hagane
Textile Research Journal = Text. Res. J.
The American Naturalist = Am. Nat.
Theoretical Chemistry Accounts = Theor. Chem. Acc.
Theoretical Foundations of Chemical Engineering = Theor. Found. Chem. Eng.
Theoretical and Experimental Chemistry = Theor. Exp. Chem.
Thermochimica Acta = Thermochim. Acta
Thin Solid Films = Thin Solid Films
Thrombosis Research = Thromb. Res.
Thrombosis and Haemostasis = Thromb. Haemostasis
Topics in Catalysis = Top. Catal.
Toxicological Sciences = Toxicol. Sci.
Toxicological and Environmental Chemistry = Toxicol. Environ. Chem.
Toxicology = Toxicology
Toxicology Letters = Toxicol. Lett.
Toxicology Mechanisms and Methods = Toxicol. Mech. Methods
Toxicology and Applied Pharmacology = Toxicol. Appl. Pharmacol.
Toxicology in Vitro = Toxicol. in Vitro
Toxicon = Toxicon
TrAC, Trends in Analytical Chemistry = TrAC, Trends Anal. Chem.
Traffic (Oxford, United Kingdom) = Traffic (Oxford, U. K.)
Transactions of the Indian Ceramic Society = Trans. Indian Ceram. Soc.
Transactions of the Institute of Metal Finishing = Trans. Inst. Met. Finish.
Transactions of the SAEST = Trans. SAEST
Transgenic Research = Transgenic Res.
Transition Metal Chemistry (Dordrecht, Netherlands) = Transition Met. Chem. (Dordrecht, Neth.)
Trends in Biochemical Sciences = Trends Biochem. Sci.
Trends in Biotechnology = Trends Biotechnol.
Trends in Endocrinology and Metabolism = Trends Endocrinol. Metab.
Trends in Food Science & Technology = Trends Food Sci. Technol.
Trends in Genetics = Trends Genet.
Trends in Immunology = Trends Immunol.
Trends in Microbiology = Trends Microbiol.
Trends in Neurosciences = Trends Neurosci.
Trends in Pharmacological Sciences = Trends Pharmacol. Sci.
Trends in Plant Science = Trends Plant Sci.
Tribology Transactions = Tribol. Trans.
Turkish Journal of Chemistry = Turk. J. Chem.
Ukrains'kii Biokhimichnii Zhurnal = Ukr. Biokhim. Zh.
Ukrains'kii Fizichnii Zhurnal = Ukr. Fiz. Zh.
Ukrainskii Khimicheskii Zhurnal (Russian Edition) = Ukr. Khim. Zh. (Russ. Ed.)
Ultramicroscopy = Ultramicroscopy
Ultrasonics Sonochemistry = Ultrason. Sonochem.
Vacuum = Vacuum
Vascular Pharmacology = Vasc. Pharmacol.
Vestnik Moskovskogo Universiteta, Seriya 2: Khimiya = Vestn. Mosk. Univ., Ser. 2: Khim.
Vestnik Sankt-Peterburgskogo Universiteta, Seriya 4: Fizika, Khimiya = Vestn. S.-Peterb. Univ., Ser. 4: Fiz., Khim.
Vestsi Natsyyanal'nai Akademii Navuk Belarusi, Seryya Khimichnykh Navuk = Vestsi Nats. Akad. Navuk Belarusi, Ser. Khim. Navuk
Vibrational Spectroscopy = Vib. Spectrosc.
Viral Immunology = Viral Immunol.
Virology = Virology
Virus Genes = Virus Genes
Virus Research = Virus Res.
Vysokomolekulyarnye Soedineniya, Seriya A i Seriya B = Vysokomol. Soedin., Ser. A Ser. B
Water Environment Research = Water Environ. Res.
Water Quality Research Journal of Canada = Water Qual. Res. J. Can.
Water Research = Water Res.
Water Resources = Water Resour.
Water, Air, & Soil Pollution = Water, Air, Soil Pollut.
Wear = Wear
Weed Science = Weed Sci.
Wood Science and Technology = Wood Sci. Technol.
Wood and Fiber Science = Wood Fiber Sci.
Wuji Huaxue Xuebao = Wuji Huaxue Xuebao
Wuli Huaxue Xuebao = Wuli Huaxue Xuebao
Wuli Xuebao = Wuli Xuebao
X-Ray Spectrometry = X-Ray Spectrom.
X-Ray Structure Analysis Online = X-Ray Struct. Anal. Online
Xenobiotica = Xenobiotica
Yakhak Hoechi = Yakhak Hoechi
Yakugaku Zasshi = Yakugaku Zasshi
Yeast = Yeast
Yingyong Huaxue = Yingyong Huaxue
Yosetsu Gakkai Ronbunshu = Yosetsu Gakkai Ronbunshu
Youji Huaxue = Youji Huaxue
Yuki Gosei Kagaku Kyokaishi = Yuki Gosei Kagaku Kyokaishi
Zeitschrift fuer Anorganische und Allgemeine Chemie = Z. Anorg. Allg. Chem.
Zeitschrift fuer Kristallographie = Z. Kristallogr.
Zeitschrift fuer Kristallographie - New Crystal Structures = Z. Kristallogr. - New Cryst. Struct.
Zeitschrift fuer Metallkunde = Z. Metallkd.
Zeitschrift fuer Naturforschung, A: Physical Sciences = Z. Naturforsch., A: Phys. Sci.
Zeitschrift fuer Naturforschung, B: Chemical Sciences = Z. Naturforsch., B: Chem. Sci.
Zeitschrift fuer Naturforschung, C: Journal of Biosciences = Z. Naturforsch., C: J. Biosci.
Zeitschrift fuer Physikalische Chemie (Muenchen, Germany) = Z. Phys. Chem. (Muenchen, Ger.)
Zhipu Xuebao = Zhipu Xuebao
Zhongguo Shengwu Huaxue Yu Fenzi Shengwu Xuebao = Zhongguo Shengwu Huaxue Yu Fenzi Shengwu Xuebao
Zhurnal Neorganicheskoi Khimii = Zh. Neorg. Khim.
Zhurnal Organichnoi ta Farmatsevtichnoi Khimii = Zh. Org. Farm. Khim.
